Coefficient,Nodes,Trial,Epsilon,Seed,GroundTruth_MIS,Greedy_MIS,Size_S,Oracle_MIS,Improvement
1,5000,0,0.05,0,2539,2539,4999,2539,0
1,5000,0,0.1,0,2539,2539,4984,2527,-12
1,5000,0,0.15,0,2539,2539,4871,2440,-99
1,5000,0,0.2,0,2539,2539,4610,2276,-263
1,5000,0,0.25,0,2539,2539,4038,2515,-24
1,5000,1,0.05,42,2560,2547,4995,2545,-2
1,5000,1,0.1,42,2560,2547,4983,2538,-9
1,5000,1,0.15,42,2560,2547,4896,2471,-76
1,5000,1,0.2,42,2560,2547,4651,2549,2
1,5000,1,0.25,42,2560,2547,4047,2534,-13
1,5000,2,0.05,84,2542,2542,4998,2542,0
1,5000,2,0.1,84,2542,2542,4986,2542,0
1,5000,2,0.15,84,2542,2542,4903,2540,-2
1,5000,2,0.2,84,2542,2542,4698,2533,-9
1,5000,2,0.25,84,2542,2542,4143,2514,-28
1,5000,3,0.05,126,2554,2554,4999,2554,0
1,5000,3,0.1,126,2554,2554,4984,2552,-2
1,5000,3,0.15,126,2554,2554,4904,2551,-3
1,5000,3,0.2,126,2554,2554,4683,2550,-4
1,5000,3,0.25,126,2554,2554,4114,2524,-30
1,5000,4,0.05,168,2540,2540,4998,2539,-1
1,5000,4,0.1,168,2540,2540,4976,2539,-1
1,5000,4,0.15,168,2540,2540,4900,2538,-2
1,5000,4,0.2,168,2540,2540,4682,2530,-10
1,5000,4,0.25,168,2540,2540,4123,2516,-24
2,5000,0,0.05,0,2500,2480,5000,2480,0
2,5000,0,0.1,0,2500,2480,4998,2478,-2
2,5000,0,0.15,0,2500,2480,4915,2392,-88
2,5000,0,0.2,0,2500,2480,4574,2479,-1
2,5000,0,0.25,0,2500,2480,3869,2497,17
2,5000,1,0.05,42,2501,2481,5000,2481,0
2,5000,1,0.1,42,2501,2481,4993,2474,-7
2,5000,1,0.15,42,2501,2481,4945,2424,-57
2,5000,1,0.2,42,2501,2481,4576,2472,-9
2,5000,1,0.25,42,2501,2481,3765,2496,15
2,5000,2,0.05,84,2500,2480,5000,2480,0
2,5000,2,0.1,84,2500,2480,4998,2478,-2
2,5000,2,0.15,84,2500,2480,4939,2418,-62
2,5000,2,0.2,84,2500,2480,4612,2476,-4
2,5000,2,0.25,84,2500,2480,3819,2497,17
2,5000,3,0.05,126,2501,2476,5000,2476,0
2,5000,3,0.1,126,2501,2476,4994,2470,-6
2,5000,3,0.15,126,2501,2476,4923,2386,-90
2,5000,3,0.2,126,2501,2476,4580,2484,8
2,5000,3,0.25,126,2501,2476,3912,2501,25
2,5000,4,0.05,168,2501,2489,5000,2489,0
2,5000,4,0.1,168,2501,2489,4994,2483,-6
2,5000,4,0.15,168,2501,2489,4935,2411,-78
2,5000,4,0.2,168,2501,2489,4626,1983,-506
2,5000,4,0.25,168,2501,2489,3881,2498,9
3,5000,0,0.05,0,2500,2469,5000,2469,0
3,5000,0,0.1,0,2500,2469,4999,2468,-1
3,5000,0,0.15,0,2500,2469,4915,2374,-95
3,5000,0,0.2,0,2500,2469,4458,2468,-1
3,5000,0,0.25,0,2500,2469,3495,2498,29
3,5000,1,0.05,42,2500,2471,5000,2471,0
3,5000,1,0.1,42,2500,2471,4996,2464,-7
3,5000,1,0.15,42,2500,2471,4946,2407,-64
3,5000,1,0.2,42,2500,2471,4525,2452,-19
3,5000,1,0.25,42,2500,2471,3497,2498,27
3,5000,2,0.05,84,2500,2473,5000,2473,0
3,5000,2,0.1,84,2500,2473,4998,2471,-2
3,5000,2,0.15,84,2500,2473,4931,2387,-86
3,5000,2,0.2,84,2500,2473,4482,2496,23
3,5000,2,0.25,84,2500,2473,3435,2500,27
3,5000,3,0.05,126,2500,2481,5000,2481,0
3,5000,3,0.1,126,2500,2481,4996,2477,-4
3,5000,3,0.15,126,2500,2481,4920,2367,-114
3,5000,3,0.2,126,2500,2481,4451,2491,10
3,5000,3,0.25,126,2500,2481,3517,2500,19
3,5000,4,0.05,168,2500,2466,5000,2466,0
3,5000,4,0.1,168,2500,2466,5000,2466,0
3,5000,4,0.15,168,2500,2466,4929,2366,-100
3,5000,4,0.2,168,2500,2466,4516,2481,15
3,5000,4,0.25,168,2500,2466,3518,2498,32
4,5000,0,0.05,0,2500,2254,5000,2254,0
4,5000,0,0.1,0,2500,2254,5000,2254,0
4,5000,0,0.15,0,2500,2254,4934,2421,167
4,5000,0,0.2,0,2500,2254,4339,2497,243
4,5000,0,0.25,0,2500,2254,3223,2500,246
4,5000,1,0.05,42,2500,2495,5000,2495,0
4,5000,1,0.1,42,2500,2495,4999,2494,-1
4,5000,1,0.15,42,2500,2495,4932,2403,-92
4,5000,1,0.2,42,2500,2495,4399,2486,-9
4,5000,1,0.25,42,2500,2495,3231,2500,5
4,5000,2,0.05,84,2500,2434,5000,2434,0
4,5000,2,0.1,84,2500,2434,4998,2432,-2
4,5000,2,0.15,84,2500,2434,4940,2386,-48
4,5000,2,0.2,84,2500,2434,4342,2497,63
4,5000,2,0.25,84,2500,2434,3147,2500,66
4,5000,3,0.05,126,2500,2343,5000,2343,0
4,5000,3,0.1,126,2500,2343,4997,2340,-3
4,5000,3,0.15,126,2500,2343,4919,2410,67
4,5000,3,0.2,126,2500,2343,4275,2500,157
4,5000,3,0.25,126,2500,2343,3243,2500,157
4,5000,4,0.05,168,2500,2302,5000,2302,0
4,5000,4,0.1,168,2500,2302,5000,2302,0
4,5000,4,0.15,168,2500,2302,4935,2386,84
4,5000,4,0.2,168,2500,2302,4390,2492,190
4,5000,4,0.25,168,2500,2302,3214,2500,198
5,5000,0,0.05,0,2500,2425,5000,2425,0
5,5000,0,0.1,0,2500,2425,5000,2425,0
5,5000,0,0.15,0,2500,2425,4900,2458,33
5,5000,0,0.2,0,2500,2425,4121,2496,71
5,5000,0,0.25,0,2500,2425,3041,2500,75
5,5000,1,0.05,42,2500,2476,5000,2476,0
5,5000,1,0.1,42,2500,2476,4999,2475,-1
5,5000,1,0.15,42,2500,2476,4934,2340,-136
5,5000,1,0.2,42,2500,2476,4206,2500,24
5,5000,1,0.25,42,2500,2476,3018,2499,23
5,5000,2,0.05,84,2500,2402,5000,2402,0
5,5000,2,0.1,84,2500,2402,4999,2401,-1
5,5000,2,0.15,84,2500,2402,4925,2383,-19
5,5000,2,0.2,84,2500,2402,4145,2500,98
5,5000,2,0.25,84,2500,2402,2990,2500,98
5,5000,3,0.05,126,2500,2445,5000,2445,0
5,5000,3,0.1,126,2500,2445,4997,2442,-3
5,5000,3,0.15,126,2500,2445,4903,2407,-38
5,5000,3,0.2,126,2500,2445,4108,2500,55
5,5000,3,0.25,126,2500,2445,3072,2500,55
5,5000,4,0.05,168,2500,2456,5000,2456,0
5,5000,4,0.1,168,2500,2456,4999,2447,-9
5,5000,4,0.15,168,2500,2456,4917,2290,-166
5,5000,4,0.2,168,2500,2456,4216,2500,44
5,5000,4,0.25,168,2500,2456,3030,2500,44
6,5000,0,0.05,0,2500,2458,5000,2458,0
6,5000,0,0.1,0,2500,2458,4999,2458,0
6,5000,0,0.15,0,2500,2458,4885,2480,22
6,5000,0,0.2,0,2500,2458,3972,2500,42
6,5000,0,0.25,0,2500,2458,2843,2500,42
6,5000,1,0.05,42,2500,2500,5000,2500,0
6,5000,1,0.1,42,2500,2500,5000,2500,0
6,5000,1,0.15,42,2500,2500,4912,2393,-107
6,5000,1,0.2,42,2500,2500,4043,2500,0
6,5000,1,0.25,42,2500,2500,2861,2500,0
6,5000,2,0.05,84,2500,2406,5000,2406,0
6,5000,2,0.1,84,2500,2406,4999,2405,-1
6,5000,2,0.15,84,2500,2406,4895,2330,-76
6,5000,2,0.2,84,2500,2406,3992,2500,94
6,5000,2,0.25,84,2500,2406,2821,2500,94
6,5000,3,0.05,126,2500,2462,5000,2462,0
6,5000,3,0.1,126,2500,2462,4997,2459,-3
6,5000,3,0.15,126,2500,2462,4859,2225,-237
6,5000,3,0.2,126,2500,2462,3967,2500,38
6,5000,3,0.25,126,2500,2462,2838,2500,38
6,5000,4,0.05,168,2500,2349,5000,2349,0
6,5000,4,0.1,168,2500,2349,5000,2349,0
6,5000,4,0.15,168,2500,2349,4893,2440,91
6,5000,4,0.2,168,2500,2349,4040,2500,151
6,5000,4,0.25,168,2500,2349,2856,2500,151
7,5000,0,0.05,0,2500,2431,5000,2431,0
7,5000,0,0.1,0,2500,2431,4999,2430,-1
7,5000,0,0.15,0,2500,2431,4862,2488,57
7,5000,0,0.2,0,2500,2431,3761,2500,69
7,5000,0,0.25,0,2500,2431,2733,2500,69
7,5000,1,0.05,42,2500,2464,5000,2464,0
7,5000,1,0.1,42,2500,2464,5000,2464,0
7,5000,1,0.15,42,2500,2464,4900,2353,-111
7,5000,1,0.2,42,2500,2464,3886,2500,36
7,5000,1,0.25,42,2500,2464,2733,2500,36
7,5000,2,0.05,84,2500,2462,5000,2462,0
7,5000,2,0.1,84,2500,2462,5000,2462,0
7,5000,2,0.15,84,2500,2462,4876,2425,-37
7,5000,2,0.2,84,2500,2462,3815,2500,38
7,5000,2,0.25,84,2500,2462,2703,2500,38
7,5000,3,0.05,126,2500,2461,5000,2461,0
7,5000,3,0.1,126,2500,2461,4997,2458,-3
7,5000,3,0.15,126,2500,2461,4838,2462,1
7,5000,3,0.2,126,2500,2461,3751,2500,39
7,5000,3,0.25,126,2500,2461,2725,2500,39
7,5000,4,0.05,168,2500,2408,5000,2408,0
7,5000,4,0.1,168,2500,2408,5000,2408,0
7,5000,4,0.15,168,2500,2408,4872,2477,69
7,5000,4,0.2,168,2500,2408,3871,2500,92
7,5000,4,0.25,168,2500,2408,2721,2500,92
8,5000,0,0.05,0,2500,2484,5000,2484,0
8,5000,0,0.1,0,2500,2484,4998,2483,-1
8,5000,0,0.15,0,2500,2484,4822,2500,16
8,5000,0,0.2,0,2500,2484,3591,2500,16
8,5000,0,0.25,0,2500,2484,2634,2500,16
8,5000,1,0.05,42,2500,2455,5000,2455,0
8,5000,1,0.1,42,2500,2455,5000,2455,0
8,5000,1,0.15,42,2500,2455,4875,2405,-50
8,5000,1,0.2,42,2500,2455,3721,2500,45
8,5000,1,0.25,42,2500,2455,2623,2500,45
8,5000,2,0.05,84,2500,2484,5000,2484,0
8,5000,2,0.1,84,2500,2484,4999,2483,-1
8,5000,2,0.15,84,2500,2484,4858,2439,-45
8,5000,2,0.2,84,2500,2484,3629,2500,16
8,5000,2,0.25,84,2500,2484,2624,2500,16
8,5000,3,0.05,126,2500,2500,5000,2500,0
8,5000,3,0.1,126,2500,2500,4996,2496,-4
8,5000,3,0.15,126,2500,2500,4812,2441,-59
8,5000,3,0.2,126,2500,2500,3561,2500,0
8,5000,3,0.25,126,2500,2500,2627,2500,0
8,5000,4,0.05,168,2500,2436,5000,2436,0
8,5000,4,0.1,168,2500,2436,4999,2435,-1
8,5000,4,0.15,168,2500,2436,4834,2442,6
8,5000,4,0.2,168,2500,2436,3714,2500,64
8,5000,4,0.25,168,2500,2436,2639,2500,64
9,5000,0,0.05,0,2500,2500,5000,2500,0
9,5000,0,0.1,0,2500,2500,5000,2500,0
9,5000,0,0.15,0,2500,2500,4771,2483,-17
9,5000,0,0.2,0,2500,2500,3397,2500,0
9,5000,0,0.25,0,2500,2500,2584,2500,0
9,5000,1,0.05,42,2500,2336,5000,2336,0
9,5000,1,0.1,42,2500,2336,5000,2336,0
9,5000,1,0.15,42,2500,2336,4847,2500,164
9,5000,1,0.2,42,2500,2336,3540,2500,164
9,5000,1,0.25,42,2500,2336,2576,2500,164
9,5000,2,0.05,84,2500,2362,5000,2362,0
9,5000,2,0.1,84,2500,2362,4998,2362,0
9,5000,2,0.15,84,2500,2362,4822,2500,138
9,5000,2,0.2,84,2500,2362,3448,2500,138
9,5000,2,0.25,84,2500,2362,2575,2500,138
9,5000,3,0.05,126,2500,2500,5000,2500,0
9,5000,3,0.1,126,2500,2500,4997,2497,-3
9,5000,3,0.15,126,2500,2500,4780,2484,-16
9,5000,3,0.2,126,2500,2500,3373,2500,0
9,5000,3,0.25,126,2500,2500,2587,2500,0
9,5000,4,0.05,168,2500,2386,5000,2386,0
9,5000,4,0.1,168,2500,2386,5000,2386,0
9,5000,4,0.15,168,2500,2386,4804,2483,97
9,5000,4,0.2,168,2500,2386,3534,2500,114
9,5000,4,0.25,168,2500,2386,2587,2500,114
10,5000,0,0.05,0,2500,2454,5000,2454,0
10,5000,0,0.1,0,2500,2454,4999,2453,-1
10,5000,0,0.15,0,2500,2454,4751,2482,28
10,5000,0,0.2,0,2500,2454,3256,2500,46
10,5000,0,0.25,0,2500,2454,2559,2500,46
10,5000,1,0.05,42,2500,2477,5000,2477,0
10,5000,1,0.1,42,2500,2477,4999,2477,0
10,5000,1,0.15,42,2500,2477,4788,2500,23
10,5000,1,0.2,42,2500,2477,3356,2500,23
10,5000,1,0.25,42,2500,2477,2536,2500,23
10,5000,2,0.05,84,2500,2458,5000,2458,0
10,5000,2,0.1,84,2500,2458,5000,2458,0
10,5000,2,0.15,84,2500,2458,4785,2500,42
10,5000,2,0.2,84,2500,2458,3297,2500,42
10,5000,2,0.25,84,2500,2458,2549,2500,42
10,5000,3,0.05,126,2500,2500,5000,2500,0
10,5000,3,0.1,126,2500,2500,4998,2498,-2
10,5000,3,0.15,126,2500,2500,4742,2483,-17
10,5000,3,0.2,126,2500,2500,3227,2500,0
10,5000,3,0.25,126,2500,2500,2553,2500,0
10,5000,4,0.05,168,2500,2433,5000,2433,0
10,5000,4,0.1,168,2500,2433,4998,2433,0
10,5000,4,0.15,168,2500,2433,4776,2500,67
10,5000,4,0.2,168,2500,2433,3357,2500,67
10,5000,4,0.25,168,2500,2433,2542,2500,67
1,10000,0,0.05,0,5058,5055,10000,5055,0
1,10000,0,0.1,0,5058,5055,9977,5036,-19
1,10000,0,0.15,0,5058,5055,9812,4896,-159
1,10000,0,0.2,0,5058,5055,9138,4409,-646
1,10000,0,0.25,0,5058,5055,8012,5029,-26
1,10000,1,0.05,42,5065,5053,9998,5052,-1
1,10000,1,0.1,42,5065,5053,9970,5036,-17
1,10000,1,0.15,42,5065,5053,9822,4915,-138
1,10000,1,0.2,42,5065,5053,9131,5052,-1
1,10000,1,0.25,42,5065,5053,8037,5040,-13
1,10000,2,0.05,84,5065,5065,10000,5065,0
1,10000,2,0.1,84,5065,5065,9979,5065,0
1,10000,2,0.15,84,5065,5065,9810,5062,-3
1,10000,2,0.2,84,5065,5065,9220,5045,-20
1,10000,2,0.25,84,5065,5065,8187,5025,-40
1,10000,3,0.05,126,5060,5059,9998,5058,-1
1,10000,3,0.1,126,5060,5059,9977,5042,-17
1,10000,3,0.15,126,5060,5059,9792,4881,-178
1,10000,3,0.2,126,5060,5059,9290,4505,-554
1,10000,3,0.25,126,5060,5059,7901,5016,-43
1,10000,4,0.05,168,5057,5057,9998,5057,0
1,10000,4,0.1,168,5057,5057,9980,5056,-1
1,10000,4,0.15,168,5057,5057,9855,5055,-2
1,10000,4,0.2,168,5057,5057,9252,5042,-15
1,10000,4,0.25,168,5057,5057,8221,5016,-41
2,10000,0,0.05,0,5002,4719,10000,4719,0
2,10000,0,0.1,0,5002,4719,9995,4706,-13
2,10000,0,0.15,0,5002,4719,9863,4741,22
2,10000,0,0.2,0,5002,4719,9266,4748,29
2,10000,0,0.25,0,5002,4719,7671,4996,277
2,10000,1,0.05,42,5001,4677,10000,4677,0
2,10000,1,0.1,42,5001,4677,9994,4673,-4
2,10000,1,0.15,42,5001,4677,9878,4588,-89
2,10000,1,0.2,42,5001,4677,9148,4629,-48
2,10000,1,0.25,42,5001,4677,7568,4993,316
2,10000,2,0.05,84,5000,4774,10000,4774,0
2,10000,2,0.1,84,5000,4774,9993,4735,-39
2,10000,2,0.15,84,5000,4774,9873,4799,25
2,10000,2,0.2,84,5000,4774,9246,4800,26
2,10000,2,0.25,84,5000,4774,7702,4997,223
2,10000,3,0.05,126,5000,4718,10000,4718,0
2,10000,3,0.1,126,5000,4718,9995,4715,-3
2,10000,3,0.15,126,5000,4718,9833,4741,23
2,10000,3,0.2,126,5000,4718,9147,4732,14
2,10000,3,0.25,126,5000,4718,7539,4993,275
2,10000,4,0.05,168,5000,4759,10000,4759,0
2,10000,4,0.1,168,5000,4759,9993,4748,-11
2,10000,4,0.15,168,5000,4759,9860,4742,-17
2,10000,4,0.2,168,5000,4759,9197,4743,-16
2,10000,4,0.25,168,5000,4759,7608,4992,233
3,10000,0,0.05,0,5000,4868,10000,4868,0
3,10000,0,0.1,0,5000,4868,9999,4867,-1
3,10000,0,0.15,0,5000,4868,9896,4580,-288
3,10000,0,0.2,0,5000,4868,9058,4961,93
3,10000,0,0.25,0,5000,4868,7029,4996,128
3,10000,1,0.05,42,5000,4857,10000,4857,0
3,10000,1,0.1,42,5000,4857,9997,4854,-3
3,10000,1,0.15,42,5000,4857,9873,4571,-286
3,10000,1,0.2,42,5000,4857,8848,4973,116
3,10000,1,0.25,42,5000,4857,6880,4998,141
3,10000,2,0.05,84,5000,4850,10000,4850,0
3,10000,2,0.1,84,5000,4850,9996,4838,-12
3,10000,2,0.15,84,5000,4850,9882,4593,-257
3,10000,2,0.2,84,5000,4850,9028,4975,125
3,10000,2,0.25,84,5000,4850,7060,4997,147
3,10000,3,0.05,126,5000,4864,10000,4864,0
3,10000,3,0.1,126,5000,4864,9995,4839,-25
3,10000,3,0.15,126,5000,4864,9871,4516,-348
3,10000,3,0.2,126,5000,4864,8878,4964,100
3,10000,3,0.25,126,5000,4864,6869,4998,134
3,10000,4,0.05,168,5000,4869,10000,4869,0
3,10000,4,0.1,168,5000,4869,9998,4867,-2
3,10000,4,0.15,168,5000,4869,9877,4581,-288
3,10000,4,0.2,168,5000,4869,8894,4982,113
3,10000,4,0.25,168,5000,4869,6911,4998,129
4,10000,0,0.05,0,5000,4874,10000,4874,0
4,10000,0,0.1,0,5000,4874,9998,4872,-2
4,10000,0,0.15,0,5000,4874,9868,4661,-213
4,10000,0,0.2,0,5000,4874,8814,4989,115
4,10000,0,0.25,0,5000,4874,6403,4999,125
4,10000,1,0.05,42,5000,4938,10000,4938,0
4,10000,1,0.1,42,5000,4938,9996,4928,-10
4,10000,1,0.15,42,5000,4938,9834,4605,-333
4,10000,1,0.2,42,5000,4938,8486,4997,59
4,10000,1,0.25,42,5000,4938,6287,4999,61
4,10000,2,0.05,84,5000,4920,10000,4920,0
4,10000,2,0.1,84,5000,4920,9996,4916,-4
4,10000,2,0.15,84,5000,4920,9859,4709,-211
4,10000,2,0.2,84,5000,4920,8668,5000,80
4,10000,2,0.25,84,5000,4920,6415,4999,79
4,10000,3,0.05,126,5000,4944,10000,4944,0
4,10000,3,0.1,126,5000,4944,9996,4940,-4
4,10000,3,0.15,126,5000,4944,9839,4746,-198
4,10000,3,0.2,126,5000,4944,8502,4996,52
4,10000,3,0.25,126,5000,4944,6218,4999,55
4,10000,4,0.05,168,5000,4916,10000,4916,0
4,10000,4,0.1,168,5000,4916,9997,4913,-3
4,10000,4,0.15,168,5000,4916,9832,4667,-249
4,10000,4,0.2,168,5000,4916,8522,4998,82
4,10000,4,0.25,168,5000,4916,6277,4999,83
5,10000,0,0.05,0,5000,4855,10000,4855,0
5,10000,0,0.1,0,5000,4855,9998,4853,-2
5,10000,0,0.15,0,5000,4855,9838,4896,41
5,10000,0,0.2,0,5000,4855,8469,5000,145
5,10000,0,0.25,0,5000,4855,5993,4999,144
5,10000,1,0.05,42,5000,4844,10000,4844,0
5,10000,1,0.1,42,5000,4844,9997,4841,-3
5,10000,1,0.15,42,5000,4844,9783,4896,52
5,10000,1,0.2,42,5000,4844,8126,5000,156
5,10000,1,0.25,42,5000,4844,5783,5000,156
5,10000,2,0.05,84,5000,4937,10000,4937,0
5,10000,2,0.1,84,5000,4937,9999,4936,-1
5,10000,2,0.15,84,5000,4937,9827,4560,-377
5,10000,2,0.2,84,5000,4937,8360,5000,63
5,10000,2,0.25,84,5000,4937,5977,5000,63
5,10000,3,0.05,126,5000,4920,10000,4920,0
5,10000,3,0.1,126,5000,4920,9998,4918,-2
5,10000,3,0.15,126,5000,4920,9794,4865,-55
5,10000,3,0.2,126,5000,4920,8181,5000,80
5,10000,3,0.25,126,5000,4920,5797,4998,78
5,10000,4,0.05,168,5000,4873,10000,4873,0
5,10000,4,0.1,168,5000,4873,9999,4872,-1
5,10000,4,0.15,168,5000,4873,9775,4878,5
5,10000,4,0.2,168,5000,4873,8145,4999,126
5,10000,4,0.25,168,5000,4873,5762,5000,127
6,10000,0,0.05,0,5000,4865,10000,4865,0
6,10000,0,0.1,0,5000,4865,9999,4864,-1
6,10000,0,0.15,0,5000,4865,9795,4863,-2
6,10000,0,0.2,0,5000,4865,8079,4999,134
6,10000,0,0.25,0,5000,4865,5581,4999,134
6,10000,1,0.05,42,5000,4896,10000,4896,0
6,10000,1,0.1,42,5000,4896,9998,4896,0
6,10000,1,0.15,42,5000,4896,9748,4968,72
6,10000,1,0.2,42,5000,4896,7724,5000,104
6,10000,1,0.25,42,5000,4896,5524,4999,103
6,10000,2,0.05,84,5000,4965,10000,4965,0
6,10000,2,0.1,84,5000,4965,9997,4950,-15
6,10000,2,0.15,84,5000,4965,9768,4842,-123
6,10000,2,0.2,84,5000,4965,7927,5000,35
6,10000,2,0.25,84,5000,4965,5553,5000,35
6,10000,3,0.05,126,5000,4946,10000,4946,0
6,10000,3,0.1,126,5000,4946,9999,4945,-1
6,10000,3,0.15,126,5000,4946,9698,4880,-66
6,10000,3,0.2,126,5000,4946,7753,5000,54
6,10000,3,0.25,126,5000,4946,5492,4999,53
6,10000,4,0.05,168,5000,4851,10000,4851,0
6,10000,4,0.1,168,5000,4851,9997,4848,-3
6,10000,4,0.15,168,5000,4851,9719,4967,116
6,10000,4,0.2,168,5000,4851,7692,4999,148
6,10000,4,0.25,168,5000,4851,5528,4999,148
7,10000,0,0.05,0,5000,4906,10000,4906,0
7,10000,0,0.1,0,5000,4906,10000,4906,0
7,10000,0,0.15,0,5000,4906,9776,4902,-4
7,10000,0,0.2,0,5000,4906,7687,5000,94
7,10000,0,0.25,0,5000,4906,5364,5000,94
7,10000,1,0.05,42,5000,4815,10000,4815,0
7,10000,1,0.1,42,5000,4815,9995,4883,68
7,10000,1,0.15,42,5000,4815,9681,4973,158
7,10000,1,0.2,42,5000,4815,7310,5000,185
7,10000,1,0.25,42,5000,4815,5279,5000,185
7,10000,2,0.05,84,5000,4928,10000,4928,0
7,10000,2,0.1,84,5000,4928,9998,4926,-2
7,10000,2,0.15,84,5000,4928,9719,4958,30
7,10000,2,0.2,84,5000,4928,7622,5000,72
7,10000,2,0.25,84,5000,4928,5330,5000,72
7,10000,3,0.05,126,5000,4917,10000,4917,0
7,10000,3,0.1,126,5000,4917,9994,4881,-36
7,10000,3,0.15,126,5000,4917,9641,4950,33
7,10000,3,0.2,126,5000,4917,7342,5000,83
7,10000,3,0.25,126,5000,4917,5277,4998,81
7,10000,4,0.05,168,5000,4830,10000,4830,0
7,10000,4,0.1,168,5000,4830,9997,4827,-3
7,10000,4,0.15,168,5000,4830,9648,4972,142
7,10000,4,0.2,168,5000,4830,7309,4999,169
7,10000,4,0.25,168,5000,4830,5323,4999,169
8,10000,0,0.05,0,5000,4861,10000,4861,0
8,10000,0,0.1,0,5000,4861,9998,4859,-2
8,10000,0,0.15,0,5000,4861,9714,4983,122
8,10000,0,0.2,0,5000,4861,7293,5000,139
8,10000,0,0.25,0,5000,4861,5208,5000,139
8,10000,1,0.05,42,5000,4727,10000,4727,0
8,10000,1,0.1,42,5000,4727,9995,4727,0
8,10000,1,0.15,42,5000,4727,9609,4970,243
8,10000,1,0.2,42,5000,4727,6913,5000,273
8,10000,1,0.25,42,5000,4727,5148,5000,273
8,10000,2,0.05,84,5000,4913,10000,4913,0
8,10000,2,0.1,84,5000,4913,10000,4913,0
8,10000,2,0.15,84,5000,4913,9635,5000,87
8,10000,2,0.2,84,5000,4913,7180,5000,87
8,10000,2,0.25,84,5000,4913,5184,5000,87
8,10000,3,0.05,126,5000,4832,10000,4832,0
8,10000,3,0.1,126,5000,4832,9995,4832,0
8,10000,3,0.15,126,5000,4832,9560,4991,159
8,10000,3,0.2,126,5000,4832,6946,5000,168
8,10000,3,0.25,126,5000,4832,5159,4999,167
8,10000,4,0.05,168,5000,4779,10000,4779,0
8,10000,4,0.1,168,5000,4779,9996,4757,-22
8,10000,4,0.15,168,5000,4779,9577,4984,205
8,10000,4,0.2,168,5000,4779,6953,5000,221
8,10000,4,0.25,168,5000,4779,5177,5000,221
9,10000,0,0.05,0,5000,4766,10000,4766,0
9,10000,0,0.1,0,5000,4766,9999,4766,0
9,10000,0,0.15,0,5000,4766,9653,4980,214
9,10000,0,0.2,0,5000,4766,6962,5000,234
9,10000,0,0.25,0,5000,4766,5116,5000,234
9,10000,1,0.05,42,5000,4877,10000,4877,0
9,10000,1,0.1,42,5000,4877,9996,4942,65
9,10000,1,0.15,42,5000,4877,9520,4962,85
9,10000,1,0.2,42,5000,4877,6554,5000,123
9,10000,1,0.25,42,5000,4877,5074,5000,123
9,10000,2,0.05,84,5000,4871,10000,4871,0
9,10000,2,0.1,84,5000,4871,9999,4870,-1
9,10000,2,0.15,84,5000,4871,9545,5000,129
9,10000,2,0.2,84,5000,4871,6833,5000,129
9,10000,2,0.25,84,5000,4871,5088,4999,128
9,10000,3,0.05,126,5000,4919,10000,4919,0
9,10000,3,0.1,126,5000,4919,9994,4913,-6
9,10000,3,0.15,126,5000,4919,9458,4986,67
9,10000,3,0.2,126,5000,4919,6636,5000,81
9,10000,3,0.25,126,5000,4919,5079,5000,81
9,10000,4,0.05,168,5000,4942,10000,4942,0
9,10000,4,0.1,168,5000,4942,9996,4938,-4
9,10000,4,0.15,168,5000,4942,9501,4984,42
9,10000,4,0.2,168,5000,4942,6556,5000,58
9,10000,4,0.25,168,5000,4942,5087,5000,58
10,10000,0,0.05,0,5000,4979,10000,4979,0
10,10000,0,0.1,0,5000,4979,9999,4978,-1
10,10000,0,0.15,0,5000,4979,9564,5000,21
10,10000,0,0.2,0,5000,4979,6630,5000,21
10,10000,0,0.25,0,5000,4979,5068,5000,21
10,10000,1,0.05,42,5000,4714,10000,4714,0
10,10000,1,0.1,42,5000,4714,9991,4714,0
10,10000,1,0.15,42,5000,4714,9405,4958,244
10,10000,1,0.2,42,5000,4714,6263,5000,286
10,10000,1,0.25,42,5000,4714,5039,5000,286
10,10000,2,0.05,84,5000,4926,10000,4926,0
10,10000,2,0.1,84,5000,4926,9998,4925,-1
10,10000,2,0.15,84,5000,4926,9469,5000,74
10,10000,2,0.2,84,5000,4926,6481,5000,74
10,10000,2,0.25,84,5000,4926,5056,5000,74
10,10000,3,0.05,126,5000,4955,10000,4955,0
10,10000,3,0.1,126,5000,4955,9992,4947,-8
10,10000,3,0.15,126,5000,4955,9354,4983,28
10,10000,3,0.2,126,5000,4955,6317,5000,45
10,10000,3,0.25,126,5000,4955,5030,4999,44
10,10000,4,0.05,168,5000,4910,10000,4910,0
10,10000,4,0.1,168,5000,4910,9995,4905,-5
10,10000,4,0.15,168,5000,4910,9389,4980,70
10,10000,4,0.2,168,5000,4910,6304,5000,90
10,10000,4,0.25,168,5000,4910,5054,5000,90
1,15000,0,0.05,0,7571,7571,14996,7571,0
1,15000,0,0.1,0,7571,7571,14969,7570,-1
1,15000,0,0.15,0,7571,7571,14737,7569,-2
1,15000,0,0.2,0,7571,7571,14002,7552,-19
1,15000,0,0.25,0,7571,7571,12536,7523,-48
1,15000,1,0.05,42,7587,7587,14998,7586,-1
1,15000,1,0.1,42,7587,7587,14956,7586,-1
1,15000,1,0.15,42,7587,7587,14685,7578,-9
1,15000,1,0.2,42,7587,7587,13919,7570,-17
1,15000,1,0.25,42,7587,7587,11988,7533,-54
1,15000,2,0.05,84,7570,7567,14996,7565,-2
1,15000,2,0.1,84,7570,7567,14960,7532,-35
1,15000,2,0.15,84,7570,7567,14653,7256,-311
1,15000,2,0.2,84,7570,7567,13829,6622,-945
1,15000,2,0.25,84,7570,7567,11715,7502,-65
1,15000,3,0.05,126,7569,7569,14997,7569,0
1,15000,3,0.1,126,7569,7569,14969,7568,-1
1,15000,3,0.15,126,7569,7569,14690,7562,-7
1,15000,3,0.2,126,7569,7569,13911,7550,-19
1,15000,3,0.25,126,7569,7569,11952,7502,-67
1,15000,4,0.05,168,7576,7576,14996,7575,-1
1,15000,4,0.1,168,7576,7576,14962,7575,-1
1,15000,4,0.15,168,7576,7576,14705,7568,-8
1,15000,4,0.2,168,7576,7576,13973,7563,-13
1,15000,4,0.25,168,7576,7576,12025,7516,-60
2,15000,0,0.05,0,7501,7230,15000,7230,0
2,15000,0,0.1,0,7501,7230,14990,7218,-12
2,15000,0,0.15,0,7501,7230,14821,6981,-249
2,15000,0,0.2,0,7501,7230,13722,7296,66
2,15000,0,0.25,0,7501,7230,11296,7499,269
2,15000,1,0.05,42,7501,7193,15000,7193,0
2,15000,1,0.1,42,7501,7193,14990,7181,-12
2,15000,1,0.15,42,7501,7193,14808,6917,-276
2,15000,1,0.2,42,7501,7193,13611,7213,20
2,15000,1,0.25,42,7501,7193,11053,7489,296
2,15000,2,0.05,84,7500,7260,15000,7260,0
2,15000,2,0.1,84,7500,7260,14985,7227,-33
2,15000,2,0.15,84,7500,7260,14827,6971,-289
2,15000,2,0.2,84,7500,7260,13563,7257,-3
2,15000,2,0.25,84,7500,7260,11036,7489,229
2,15000,3,0.05,126,7500,7218,15000,7218,0
2,15000,3,0.1,126,7500,7218,14996,7215,-3
2,15000,3,0.15,126,7500,7218,14856,6995,-223
2,15000,3,0.2,126,7500,7218,13704,7309,91
2,15000,3,0.25,126,7500,7218,11282,7493,275
2,15000,4,0.05,168,7501,7270,15000,7270,0
2,15000,4,0.1,168,7501,7270,14992,7262,-8
2,15000,4,0.15,168,7501,7270,14819,6943,-327
2,15000,4,0.2,168,7501,7270,13550,7194,-76
2,15000,4,0.25,168,7501,7270,11007,7491,221
3,15000,0,0.05,0,7500,7392,15000,7392,0
3,15000,0,0.1,0,7500,7392,14999,7391,-1
3,15000,0,0.15,0,7500,7392,14818,7141,-251
3,15000,0,0.2,0,7500,7392,13364,7468,76
3,15000,0,0.25,0,7500,7392,10249,7498,106
3,15000,1,0.05,42,7500,7286,15000,7286,0
3,15000,1,0.1,42,7500,7286,14993,7280,-6
3,15000,1,0.15,42,7500,7286,14787,6937,-349
3,15000,1,0.2,42,7500,7286,13197,7485,199
3,15000,1,0.25,42,7500,7286,10018,7494,208
3,15000,2,0.05,84,7500,7323,15000,7323,0
3,15000,2,0.1,84,7500,7323,14993,7316,-7
3,15000,2,0.15,84,7500,7323,14779,7001,-322
3,15000,2,0.2,84,7500,7323,13221,7479,156
3,15000,2,0.25,84,7500,7323,9978,7494,171
3,15000,3,0.05,126,7500,7366,15000,7366,0
3,15000,3,0.1,126,7500,7366,14994,7360,-6
3,15000,3,0.15,126,7500,7366,14814,7065,-301
3,15000,3,0.2,126,7500,7366,13325,7489,123
3,15000,3,0.25,126,7500,7366,10196,7497,131
3,15000,4,0.05,168,7500,7354,15000,7354,0
3,15000,4,0.1,168,7500,7354,14993,7348,-6
3,15000,4,0.15,168,7500,7354,14764,7046,-308
3,15000,4,0.2,168,7500,7354,13141,7473,119
3,15000,4,0.25,168,7500,7354,9938,7494,140
4,15000,0,0.05,0,7500,7223,15000,7223,0
4,15000,0,0.1,0,7500,7223,14998,7214,-9
4,15000,0,0.15,0,7500,7223,14767,7328,105
4,15000,0,0.2,0,7500,7223,12920,7500,277
4,15000,0,0.25,0,7500,7223,9540,7500,277
4,15000,1,0.05,42,7500,7245,15000,7245,0
4,15000,1,0.1,42,7500,7245,14994,7239,-6
4,15000,1,0.15,42,7500,7245,14742,7312,67
4,15000,1,0.2,42,7500,7245,12662,7500,255
4,15000,1,0.25,42,7500,7245,9318,7499,254
4,15000,2,0.05,84,7500,7279,15000,7279,0
4,15000,2,0.1,84,7500,7279,14993,7237,-42
4,15000,2,0.15,84,7500,7279,14730,7312,33
4,15000,2,0.2,84,7500,7279,12726,7496,217
4,15000,2,0.25,84,7500,7279,9283,7498,219
4,15000,3,0.05,126,7500,7229,15000,7229,0
4,15000,3,0.1,126,7500,7229,14997,7226,-3
4,15000,3,0.15,126,7500,7229,14762,7376,147
4,15000,3,0.2,126,7500,7229,12892,7495,266
4,15000,3,0.25,126,7500,7229,9490,7499,270
4,15000,4,0.05,168,7500,7340,15000,7340,0
4,15000,4,0.1,168,7500,7340,14997,7330,-10
4,15000,4,0.15,168,7500,7340,14706,7213,-127
4,15000,4,0.2,168,7500,7340,12661,7499,159
4,15000,4,0.25,168,7500,7340,9279,7497,157
5,15000,0,0.05,0,7500,7056,15000,7056,0
5,15000,0,0.1,0,7500,7056,14998,6995,-61
5,15000,0,0.15,0,7500,7056,14743,7201,145
5,15000,0,0.2,0,7500,7056,12399,7500,444
5,15000,0,0.25,0,7500,7056,8835,7500,444
5,15000,1,0.05,42,7500,7254,15000,7254,0
5,15000,1,0.1,42,7500,7254,14996,7250,-4
5,15000,1,0.15,42,7500,7254,14700,7325,71
5,15000,1,0.2,42,7500,7254,12147,7500,246
5,15000,1,0.25,42,7500,7254,8685,7499,245
5,15000,2,0.05,84,7500,7273,15000,7273,0
5,15000,2,0.1,84,7500,7273,14993,7267,-6
5,15000,2,0.15,84,7500,7273,14683,7216,-57
5,15000,2,0.2,84,7500,7273,12034,7500,227
5,15000,2,0.25,84,7500,7273,8492,7498,225
5,15000,3,0.05,126,7500,7201,15000,7201,0
5,15000,3,0.1,126,7500,7201,14998,7200,-1
5,15000,3,0.15,126,7500,7201,14743,7369,168
5,15000,3,0.2,126,7500,7201,12301,7500,299
5,15000,3,0.25,126,7500,7201,8701,7500,299
5,15000,4,0.05,168,7500,7476,15000,7476,0
5,15000,4,0.1,168,7500,7476,14999,7475,-1
5,15000,4,0.15,168,7500,7476,14637,6904,-572
5,15000,4,0.2,168,7500,7476,11992,7500,24
5,15000,4,0.25,168,7500,7476,8502,7497,21
6,15000,0,0.05,0,7500,7338,15000,7338,0
6,15000,0,0.1,0,7500,7338,14999,7338,0
6,15000,0,0.15,0,7500,7338,14677,7332,-6
6,15000,0,0.2,0,7500,7338,11751,7500,162
6,15000,0,0.25,0,7500,7338,8322,7500,162
6,15000,1,0.05,42,7500,7208,15000,7208,0
6,15000,1,0.1,42,7500,7208,14992,7200,-8
6,15000,1,0.15,42,7500,7208,14585,7464,256
6,15000,1,0.2,42,7500,7208,11482,7500,292
6,15000,1,0.25,42,7500,7208,8179,7500,292
6,15000,2,0.05,84,7500,7239,15000,7239,0
6,15000,2,0.1,84,7500,7239,14991,7191,-48
6,15000,2,0.15,84,7500,7239,14627,7068,-171
6,15000,2,0.2,84,7500,7239,11381,7500,261
6,15000,2,0.25,84,7500,7239,8138,7500,261
6,15000,3,0.05,126,7500,7242,15000,7242,0
6,15000,3,0.1,126,7500,7242,14998,7241,-1
6,15000,3,0.15,126,7500,7242,14704,7389,147
6,15000,3,0.2,126,7500,7242,11669,7500,258
6,15000,3,0.25,126,7500,7242,8318,7500,258
6,15000,4,0.05,168,7500,7455,15000,7455,0
6,15000,4,0.1,168,7500,7455,14993,7448,-7
6,15000,4,0.15,168,7500,7455,14561,7322,-133
6,15000,4,0.2,168,7500,7455,11448,7500,45
6,15000,4,0.25,168,7500,7455,8163,7499,44
7,15000,0,0.05,0,7500,7389,15000,7389,0
7,15000,0,0.1,0,7500,7389,14999,7388,-1
7,15000,0,0.15,0,7500,7389,14588,7455,66
7,15000,0,0.2,0,7500,7389,11122,7500,111
7,15000,0,0.25,0,7500,7389,7968,7500,111
7,15000,1,0.05,42,7500,7405,15000,7405,0
7,15000,1,0.1,42,7500,7405,14996,7405,0
7,15000,1,0.15,42,7500,7405,14463,7500,95
7,15000,1,0.2,42,7500,7405,10828,7500,95
7,15000,1,0.25,42,7500,7405,7888,7500,95
7,15000,2,0.05,84,7500,7161,15000,7161,0
7,15000,2,0.1,84,7500,7161,14995,7156,-5
7,15000,2,0.15,84,7500,7161,14485,7430,269
7,15000,2,0.2,84,7500,7161,10820,7500,339
7,15000,2,0.25,84,7500,7161,7838,7500,339
7,15000,3,0.05,126,7500,7241,15000,7241,0
7,15000,3,0.1,126,7500,7241,14998,7015,-226
7,15000,3,0.15,126,7500,7241,14598,7460,219
7,15000,3,0.2,126,7500,7241,11065,7500,259
7,15000,3,0.25,126,7500,7241,7954,7500,259
7,15000,4,0.05,168,7500,7406,15000,7406,0
7,15000,4,0.1,168,7500,7406,14995,7401,-5
7,15000,4,0.15,168,7500,7406,14432,7366,-40
7,15000,4,0.2,168,7500,7406,10822,7500,94
7,15000,4,0.25,168,7500,7406,7853,7500,94
8,15000,0,0.05,0,7500,7427,15000,7427,0
8,15000,0,0.1,0,7500,7427,14997,7424,-3
8,15000,0,0.15,0,7500,7427,14475,7465,38
8,15000,0,0.2,0,7500,7427,10615,7500,73
8,15000,0,0.25,0,7500,7427,7770,7500,73
8,15000,1,0.05,42,7500,7151,15000,7151,0
8,15000,1,0.1,42,7500,7151,14999,7150,-1
8,15000,1,0.15,42,7500,7151,14344,7500,349
8,15000,1,0.2,42,7500,7151,10331,7500,349
8,15000,1,0.25,42,7500,7151,7710,7500,349
8,15000,2,0.05,84,7500,7468,15000,7468,0
8,15000,2,0.1,84,7500,7468,14994,7462,-6
8,15000,2,0.15,84,7500,7468,14364,7471,3
8,15000,2,0.2,84,7500,7468,10280,7500,32
8,15000,2,0.25,84,7500,7468,7695,7500,32
8,15000,3,0.05,126,7500,7281,15000,7281,0
8,15000,3,0.1,126,7500,7281,14999,7280,-1
8,15000,3,0.15,126,7500,7281,14524,7464,183
8,15000,3,0.2,126,7500,7281,10520,7500,219
8,15000,3,0.25,126,7500,7281,7763,7500,219
8,15000,4,0.05,168,7500,7462,15000,7462,0
8,15000,4,0.1,168,7500,7462,14998,7460,-2
8,15000,4,0.15,168,7500,7462,14307,7466,4
8,15000,4,0.2,168,7500,7462,10174,7500,38
8,15000,4,0.25,168,7500,7462,7686,7500,38
9,15000,0,0.05,0,7500,7478,15000,7478,0
9,15000,0,0.1,0,7500,7478,14995,7473,-5
9,15000,0,0.15,0,7500,7478,14373,7461,-17
9,15000,0,0.2,0,7500,7478,10078,7500,22
9,15000,0,0.25,0,7500,7478,7660,7500,22
9,15000,1,0.05,42,7500,7372,15000,7372,0
9,15000,1,0.1,42,7500,7372,14997,7369,-3
9,15000,1,0.15,42,7500,7372,14205,7500,128
9,15000,1,0.2,42,7500,7372,9801,7500,128
9,15000,1,0.25,42,7500,7372,7615,7500,128
9,15000,2,0.05,84,7500,7306,15000,7306,0
9,15000,2,0.1,84,7500,7306,14995,7301,-5
9,15000,2,0.15,84,7500,7306,14188,7463,157
9,15000,2,0.2,84,7500,7306,9718,7500,194
9,15000,2,0.25,84,7500,7306,7605,7500,194
9,15000,3,0.05,126,7500,7302,15000,7302,0
9,15000,3,0.1,126,7500,7302,14999,7302,0
9,15000,3,0.15,126,7500,7302,14418,7458,156
9,15000,3,0.2,126,7500,7302,10038,7500,198
9,15000,3,0.25,126,7500,7302,7652,7500,198
9,15000,4,0.05,168,7500,7413,15000,7413,0
9,15000,4,0.1,168,7500,7413,14992,7405,-8
9,15000,4,0.15,168,7500,7413,14125,7500,87
9,15000,4,0.2,168,7500,7413,9603,7500,87
9,15000,4,0.25,168,7500,7413,7590,7500,87
10,15000,0,0.05,0,7500,7222,15000,7222,0
10,15000,0,0.1,0,7500,7222,14994,7216,-6
10,15000,0,0.15,0,7500,7222,14278,7477,255
10,15000,0,0.2,0,7500,7222,9539,7500,278
10,15000,0,0.25,0,7500,7222,7584,7500,278
10,15000,1,0.05,42,7500,7328,15000,7328,0
10,15000,1,0.1,42,7500,7328,14994,7323,-5
10,15000,1,0.15,42,7500,7328,13993,7500,172
10,15000,1,0.2,42,7500,7328,9324,7500,172
10,15000,1,0.25,42,7500,7328,7553,7500,172
10,15000,2,0.05,84,7500,7274,15000,7274,0
10,15000,2,0.1,84,7500,7274,14993,7267,-7
10,15000,2,0.15,84,7500,7274,14042,7481,207
10,15000,2,0.2,84,7500,7274,9229,7500,226
10,15000,2,0.25,84,7500,7274,7554,7500,226
10,15000,3,0.05,126,7500,7425,15000,7425,0
10,15000,3,0.1,126,7500,7425,14999,7424,-1
10,15000,3,0.15,126,7500,7425,14259,7500,75
10,15000,3,0.2,126,7500,7425,9522,7500,75
10,15000,3,0.25,126,7500,7425,7567,7500,75
10,15000,4,0.05,168,7500,7428,15000,7428,0
10,15000,4,0.1,168,7500,7428,14994,7422,-6
10,15000,4,0.15,168,7500,7428,13923,7500,72
10,15000,4,0.2,168,7500,7428,9168,7500,72
10,15000,4,0.25,168,7500,7428,7549,7500,72
1,20000,0,0.05,0,10081,10064,19999,10063,-1
1,20000,0,0.1,0,10081,10064,19966,10036,-28
1,20000,0,0.15,0,10081,10064,19711,9806,-258
1,20000,0,0.2,0,10081,10064,18543,8835,-1229
1,20000,0,0.25,0,10081,10064,16348,10039,-25
1,20000,1,0.05,42,10081,10081,19998,10081,0
1,20000,1,0.1,42,10081,10081,19963,10081,0
1,20000,1,0.15,42,10081,10081,19715,10080,-1
1,20000,1,0.2,42,10081,10081,18565,10073,-8
1,20000,1,0.25,42,10081,10081,16577,10049,-32
1,20000,2,0.05,84,10092,10092,19995,10091,-1
1,20000,2,0.1,84,10092,10092,19959,10089,-3
1,20000,2,0.15,84,10092,10092,19750,10088,-4
1,20000,2,0.2,84,10092,10092,18762,10073,-19
1,20000,2,0.25,84,10092,10092,16738,10039,-53
1,20000,3,0.05,126,10079,10079,19997,10079,0
1,20000,3,0.1,126,10079,10079,19958,10078,-1
1,20000,3,0.15,126,10079,10079,19712,10072,-7
1,20000,3,0.2,126,10079,10079,18630,10053,-26
1,20000,3,0.25,126,10079,10079,16570,10026,-53
1,20000,4,0.05,168,10071,10069,19999,10068,-1
1,20000,4,0.1,168,10071,10069,19962,10033,-36
1,20000,4,0.15,168,10071,10069,19706,9800,-269
1,20000,4,0.2,168,10071,10069,18384,8747,-1322
1,20000,4,0.25,168,10071,10069,16237,10017,-52
2,20000,0,0.05,0,10001,9803,20000,9803,0
2,20000,0,0.1,0,10001,9803,19995,9792,-11
2,20000,0,0.15,0,10001,9803,19740,9386,-417
2,20000,0,0.2,0,10001,9803,18395,9720,-83
2,20000,0,0.25,0,10001,9803,15110,9995,192
2,20000,1,0.05,42,10001,9804,20000,9804,0
2,20000,1,0.1,42,10001,9804,19994,9796,-8
2,20000,1,0.15,42,10001,9804,19690,9359,-445
2,20000,1,0.2,42,10001,9804,18238,9789,-15
2,20000,1,0.25,42,10001,9804,14981,9987,183
2,20000,2,0.05,84,10001,9740,20000,9740,0
2,20000,2,0.1,84,10001,9740,19993,9740,0
2,20000,2,0.15,84,10001,9740,19749,9736,-4
2,20000,2,0.2,84,10001,9740,18142,9975,235
2,20000,2,0.25,84,10001,9740,14758,9984,244
2,20000,3,0.05,126,10001,9709,20000,9709,0
2,20000,3,0.1,126,10001,9709,19981,9691,-18
2,20000,3,0.15,126,10001,9709,19711,9268,-441
2,20000,3,0.2,126,10001,9709,18292,9788,79
2,20000,3,0.25,126,10001,9709,14986,9992,283
2,20000,4,0.05,168,10001,9694,20000,9694,0
2,20000,4,0.1,168,10001,9694,19986,9678,-16
2,20000,4,0.15,168,10001,9694,19719,9249,-445
2,20000,4,0.2,168,10001,9694,18250,9795,101
2,20000,4,0.25,168,10001,9694,14982,9987,293
3,20000,0,0.05,0,10000,9893,20000,9893,0
3,20000,0,0.1,0,10000,9893,19997,9890,-3
3,20000,0,0.15,0,10000,9893,19737,9547,-346
3,20000,0,0.2,0,10000,9893,17828,9984,91
3,20000,0,0.25,0,10000,9893,13607,9998,105
3,20000,1,0.05,42,10000,9879,20000,9879,0
3,20000,1,0.1,42,10000,9879,19995,9874,-5
3,20000,1,0.15,42,10000,9879,19691,9461,-418
3,20000,1,0.2,42,10000,9879,17466,9983,104
3,20000,1,0.25,42,10000,9879,13468,9994,115
3,20000,2,0.05,84,10000,9858,20000,9858,0
3,20000,2,0.1,84,10000,9858,19991,9845,-13
3,20000,2,0.15,84,10000,9858,19703,9453,-405
3,20000,2,0.2,84,10000,9858,17563,9986,128
3,20000,2,0.25,84,10000,9858,13555,9996,138
3,20000,3,0.05,126,10000,9817,20000,9817,0
3,20000,3,0.1,126,10000,9817,19991,9804,-13
3,20000,3,0.15,126,10000,9817,19683,9405,-412
3,20000,3,0.2,126,10000,9817,17608,9975,158
3,20000,3,0.25,126,10000,9817,13469,9994,177
3,20000,4,0.05,168,10000,9877,20000,9877,0
3,20000,4,0.1,168,10000,9877,19991,9865,-12
3,20000,4,0.15,168,10000,9877,19714,9481,-396
3,20000,4,0.2,168,10000,9877,17527,9966,89
3,20000,4,0.25,168,10000,9877,13468,9994,117
4,20000,0,0.05,0,10000,9819,20000,9819,0
4,20000,0,0.1,0,10000,9819,19998,9817,-2
4,20000,0,0.15,0,10000,9819,19702,9327,-492
4,20000,0,0.2,0,10000,9819,17066,10000,181
4,20000,0,0.25,0,10000,9819,12280,9999,180
4,20000,1,0.05,42,10000,9873,20000,9873,0
4,20000,1,0.1,42,10000,9873,19994,9867,-6
4,20000,1,0.15,42,10000,9873,19635,9787,-86
4,20000,1,0.2,42,10000,9873,16790,9996,123
4,20000,1,0.25,42,10000,9873,12186,10000,127
4,20000,2,0.05,84,10000,9750,20000,9750,0
4,20000,2,0.1,84,10000,9750,19992,9743,-7
4,20000,2,0.15,84,10000,9750,19644,9751,1
4,20000,2,0.2,84,10000,9750,16957,9995,245
4,20000,2,0.25,84,10000,9750,12207,9999,249
4,20000,3,0.05,126,10000,9780,20000,9780,0
4,20000,3,0.1,126,10000,9780,19990,9758,-22
4,20000,3,0.15,126,10000,9780,19660,9023,-757
4,20000,3,0.2,126,10000,9780,16884,9996,216
4,20000,3,0.25,126,10000,9780,12156,9998,218
4,20000,4,0.05,168,10000,9749,20000,9749,0
4,20000,4,0.1,168,10000,9749,19995,9745,-4
4,20000,4,0.15,168,10000,9749,19664,8868,-881
4,20000,4,0.2,168,10000,9749,16822,10000,251
4,20000,4,0.25,168,10000,9749,12185,9997,248
5,20000,0,0.05,0,10000,9815,20000,9815,0
5,20000,0,0.1,0,10000,9815,19994,9809,-6
5,20000,0,0.15,0,10000,9815,19622,9801,-14
5,20000,0,0.2,0,10000,9815,16402,10000,185
5,20000,0,0.25,0,10000,9815,11494,10000,185
5,20000,1,0.05,42,10000,9874,20000,9874,0
5,20000,1,0.1,42,10000,9874,19992,9866,-8
5,20000,1,0.15,42,10000,9874,19491,9806,-68
5,20000,1,0.2,42,10000,9874,16026,10000,126
5,20000,1,0.25,42,10000,9874,11325,9998,124
5,20000,2,0.05,84,10000,9694,20000,9694,0
5,20000,2,0.1,84,10000,9694,19996,9691,-3
5,20000,2,0.15,84,10000,9694,19565,9787,93
5,20000,2,0.2,84,10000,9694,16050,10000,306
5,20000,2,0.25,84,10000,9694,11404,9997,303
5,20000,3,0.05,126,10000,9761,20000,9761,0
5,20000,3,0.1,126,10000,9761,19994,9755,-6
5,20000,3,0.15,126,10000,9761,19575,9764,3
5,20000,3,0.2,126,10000,9761,16086,10000,239
5,20000,3,0.25,126,10000,9761,11345,9998,237
5,20000,4,0.05,168,10000,9730,20000,9730,0
5,20000,4,0.1,168,10000,9730,19995,9705,-25
5,20000,4,0.15,168,10000,9730,19591,9774,44
5,20000,4,0.2,168,10000,9730,15974,10000,270
5,20000,4,0.25,168,10000,9730,11353,9999,269
6,20000,0,0.05,0,10000,9885,20000,9885,0
6,20000,0,0.1,0,10000,9885,19996,9881,-4
6,20000,0,0.15,0,10000,9885,19536,9752,-133
6,20000,0,0.2,0,10000,9885,15490,10000,115
6,20000,0,0.25,0,10000,9885,10956,9999,114
6,20000,1,0.05,42,10000,9812,20000,9812,0
6,20000,1,0.1,42,10000,9812,19987,9786,-26
6,20000,1,0.15,42,10000,9812,19411,9789,-23
6,20000,1,0.2,42,10000,9812,15122,10000,188
6,20000,1,0.25,42,10000,9812,10821,9999,187
6,20000,2,0.05,84,10000,9672,20000,9672,0
6,20000,2,0.1,84,10000,9672,19995,9669,-3
6,20000,2,0.15,84,10000,9672,19460,9767,95
6,20000,2,0.2,84,10000,9672,15253,10000,328
6,20000,2,0.25,84,10000,9672,10909,9999,327
6,20000,3,0.05,126,10000,9437,20000,9437,0
6,20000,3,0.1,126,10000,9437,19991,9437,0
6,20000,3,0.15,126,10000,9437,19457,9896,459
6,20000,3,0.2,126,10000,9437,15323,10000,563
6,20000,3,0.25,126,10000,9437,10865,10000,563
6,20000,4,0.05,168,10000,9926,20000,9926,0
6,20000,4,0.1,168,10000,9926,19995,9921,-5
6,20000,4,0.15,168,10000,9926,19498,9874,-52
6,20000,4,0.2,168,10000,9926,15175,10000,74
