Coefficient,Nodes,Trial,Epsilon,Seed,GroundTruth_MIS,Greedy_MIS,Size_S,Oracle_MIS,Improvement
14.0,95000,0,0.025,0,47500,47120,95000,47120,0
2.0,95000,0,0.025,0,47500,44873,95000,44873,0
5.0,95000,0,0.025,0,47500,46920,95000,46920,0
3.0,95000,0,0.025,0,47500,45482,95000,45482,0
13.0,95000,0,0.025,0,47500,46619,95000,46619,0
6.0,95000,0,0.025,0,47500,46761,95000,46761,0
7.0,95000,0,0.025,0,47500,46387,95000,46387,0
12.0,95000,0,0.025,0,47500,46997,95000,46997,0
11.0,95000,0,0.025,0,47500,46873,95000,46873,0
10.0,95000,0,0.025,0,47500,46920,95000,46920,0
4.0,95000,0,0.025,0,47500,46530,95000,46530,0
8.0,95000,0,0.025,0,47500,46719,95000,46719,0
9.0,95000,0,0.025,0,47500,46743,95000,46743,0
1.0,95000,0,0.025,0,47652,47652,95000,47652,0
14.0,95000,0,0.05,0,47500,47120,95000,47120,0
14.0,95000,0,0.075,0,47500,47120,94997,47117,-3
2.0,95000,0,0.05,0,47500,44873,95000,44873,0
13.0,95000,0,0.05,0,47500,46619,95000,46619,0
12.0,95000,0,0.05,0,47500,46997,95000,46997,0
5.0,95000,0,0.05,0,47500,46920,95000,46920,0
6.0,95000,0,0.05,0,47500,46761,95000,46761,0
7.0,95000,0,0.05,0,47500,46387,95000,46387,0
11.0,95000,0,0.05,0,47500,46873,95000,46873,0
10.0,95000,0,0.05,0,47500,46920,95000,46920,0
8.0,95000,0,0.05,0,47500,46719,95000,46719,0
9.0,95000,0,0.05,0,47500,46743,95000,46743,0
14.0,95000,0,0.1,0,47500,47120,94902,46682,-438
3.0,95000,0,0.05,0,47500,45482,95000,45482,0
4.0,95000,0,0.05,0,47500,46530,95000,46530,0
1.0,95000,0,0.05,0,47652,47652,94996,47652,0
14.0,95000,0,0.125,0,47500,47120,92705,47454,334
13.0,95000,0,0.075,0,47500,46619,94998,46618,-1
12.0,95000,0,0.075,0,47500,46997,94999,46996,-1
2.0,95000,0,0.075,0,47500,44873,94995,44868,-5
14.0,95000,0,0.15,0,47500,47120,80405,47500,380
11.0,95000,0,0.075,0,47500,46873,94999,46872,-1
6.0,95000,0,0.075,0,47500,46761,94999,46760,-1
7.0,95000,0,0.075,0,47500,46387,94999,46386,-1
5.0,95000,0,0.075,0,47500,46920,94998,46918,-2
10.0,95000,0,0.075,0,47500,46920,94997,46917,-3
8.0,95000,0,0.075,0,47500,46719,94999,46718,-1
9.0,95000,0,0.075,0,47500,46743,94998,46741,-2
3.0,95000,0,0.075,0,47500,45482,94999,45463,-19
4.0,95000,0,0.075,0,47500,46530,95000,46530,0
14.0,95000,0,0.175,0,47500,47120,59969,47500,380
13.0,95000,0,0.1,0,47500,46619,94925,46455,-164
12.0,95000,0,0.1,0,47500,46997,94933,46931,-66
15.0,95000,0,0.025,0,47500,46759,95000,46759,0
14.0,95000,0,0.2,0,47500,47120,49334,47500,380
1.0,95000,0,0.075,0,47652,47652,94970,47651,-1
11.0,95000,0,0.1,0,47500,46873,94957,46795,-78
2.0,95000,0,0.1,0,47500,44873,94963,44816,-57
6.0,95000,0,0.1,0,47500,46761,94980,46742,-19
7.0,95000,0,0.1,0,47500,46387,94978,46365,-22
8.0,95000,0,0.1,0,47500,46719,94960,46681,-38
10.0,95000,0,0.1,0,47500,46920,94956,46781,-139
9.0,95000,0,0.1,0,47500,46743,94960,46703,-40
5.0,95000,0,0.1,0,47500,46920,94979,46900,-20
14.0,95000,0,0.225,0,47500,47120,47603,47500,380
4.0,95000,0,0.1,0,47500,46530,94982,46514,-16
15.0,95000,0,0.05,0,47500,46759,95000,46759,0
3.0,95000,0,0.1,0,47500,45482,94975,45304,-178
13.0,95000,0,0.125,0,47500,46619,93145,47417,798
14.0,95000,0,0.25,0,47500,47120,47502,47500,380
12.0,95000,0,0.125,0,47500,46997,93460,47028,31
15.0,95000,0,0.075,0,47500,46759,94998,46757,-2
11.0,95000,0,0.125,0,47500,46873,93747,47006,133
14.0,95000,1,0.025,42,47500,46228,95000,46228,0
6.0,95000,0,0.125,0,47500,46761,94604,46120,-641
2.0,95000,0,0.125,0,47500,44873,94735,44355,-518
7.0,95000,0,0.125,0,47500,46387,94524,45348,-1039
10.0,95000,0,0.125,0,47500,46920,94019,46848,-72
8.0,95000,0,0.125,0,47500,46719,94341,46584,-135
9.0,95000,0,0.125,0,47500,46743,94251,46714,-29
1.0,95000,0,0.1,0,47652,47652,94871,47649,-3
5.0,95000,0,0.125,0,47500,46920,94665,46471,-449
13.0,95000,0,0.15,0,47500,46619,82397,47500,881
4.0,95000,0,0.125,0,47500,46530,94739,46089,-441
14.0,95000,1,0.05,42,47500,46228,95000,46228,0
15.0,95000,0,0.1,0,47500,46759,94896,46658,-101
12.0,95000,0,0.15,0,47500,46997,84344,47500,503
3.0,95000,0,0.125,0,47500,45482,94745,44814,-668
14.0,95000,1,0.075,42,47500,46228,95000,46228,0
11.0,95000,0,0.15,0,47500,46873,86098,47500,627
15.0,95000,0,0.125,0,47500,46759,92228,47500,741
6.0,95000,0,0.15,0,47500,46761,92253,46821,60
2.0,95000,0,0.15,0,47500,44873,93904,45023,150
10.0,95000,0,0.15,0,47500,46920,87657,47500,580
13.0,95000,0,0.175,0,47500,46619,62350,47500,881
8.0,95000,0,0.15,0,47500,46719,90266,47500,781
7.0,95000,0,0.15,0,47500,46387,91352,47288,901
9.0,95000,0,0.15,0,47500,46743,89050,47476,733
14.0,95000,1,0.1,42,47500,46228,94895,46228,0
12.0,95000,0,0.175,0,47500,46997,64829,47500,503
5.0,95000,0,0.15,0,47500,46920,92752,46972,52
4.0,95000,0,0.15,0,47500,46530,93366,46356,-174
1.0,95000,0,0.125,0,47652,47652,94528,47647,-5
15.0,95000,0,0.15,0,47500,46759,78202,47500,741
3.0,95000,0,0.15,0,47500,45482,93696,45008,-474
14.0,95000,1,0.125,42,47500,46228,92461,47410,1182
13.0,95000,0,0.2,0,47500,46619,50253,47500,881
11.0,95000,0,0.175,0,47500,46873,68183,47500,627
6.0,95000,0,0.175,0,47500,46761,84057,47500,739
15.0,95000,0,0.175,0,47500,46759,57598,47500,741
10.0,95000,0,0.175,0,47500,46920,71472,47500,580
8.0,95000,0,0.175,0,47500,46719,77933,47500,781
7.0,95000,0,0.175,0,47500,46387,81022,47500,1113
9.0,95000,0,0.175,0,47500,46743,74929,47500,757
2.0,95000,0,0.175,0,47500,44873,91477,45047,174
14.0,95000,1,0.15,42,47500,46228,79550,47500,1272
12.0,95000,0,0.2,0,47500,46997,51436,47500,503
5.0,95000,0,0.175,0,47500,46920,86366,47500,580
4.0,95000,0,0.175,0,47500,46530,88531,47185,655
14.0,95000,1,0.175,42,47500,46228,58909,47500,1272
15.0,95000,0,0.2,0,47500,46759,48699,47500,741
13.0,95000,0,0.225,0,47500,46619,47699,47500,881
11.0,95000,0,0.2,0,47500,46873,53062,47500,627
3.0,95000,0,0.175,0,47500,45482,89834,47063,1581
1.0,95000,0,0.15,0,47652,47652,93422,47622,-30
12.0,95000,0,0.225,0,47500,46997,47874,47500,503
14.0,95000,1,0.2,42,47500,46228,49096,47500,1272
10.0,95000,0,0.2,0,47500,46920,55242,47500,580
6.0,95000,0,0.2,0,47500,46761,69461,47500,739
8.0,95000,0,0.2,0,47500,46719,61101,47498,779
9.0,95000,0,0.2,0,47500,46743,58145,47500,757
15.0,95000,0,0.225,0,47500,46759,47551,47500,741
7.0,95000,0,0.2,0,47500,46387,65385,47500,1113
2.0,95000,0,0.2,0,47500,44873,85652,47150,2277
14.0,95000,1,0.225,42,47500,46228,47580,47500,1272
13.0,95000,0,0.25,0,47500,46619,47505,47500,881
5.0,95000,0,0.2,0,47500,46920,73971,47500,580
4.0,95000,0,0.2,0,47500,46530,78434,47499,969
15.0,95000,0,0.25,0,47500,46759,47501,47500,741
11.0,95000,0,0.225,0,47500,46873,48234,47500,627
14.0,95000,1,0.25,42,47500,46228,47503,47500,1272
12.0,95000,0,0.25,0,47500,46997,47517,47500,503
10.0,95000,0,0.225,0,47500,46920,48814,47500,580
6.0,95000,0,0.225,0,47500,46761,56600,47497,736
8.0,95000,0,0.225,0,47500,46719,51219,47498,779
3.0,95000,0,0.2,0,47500,45482,82391,47488,2006
9.0,95000,0,0.225,0,47500,46743,49713,47500,757
7.0,95000,0,0.225,0,47500,46387,53430,47498,1111
15.0,95000,1,0.025,42,47500,46764,95000,46764,0
14.0,95000,2,0.025,84,47500,47024,95000,47024,0
1.0,95000,0,0.175,0,47652,47652,92133,47625,-27
13.0,95000,1,0.025,42,47500,46447,95000,46447,0
2.0,95000,0,0.225,0,47500,44873,77936,47440,2567
11.0,95000,0,0.25,0,47500,46873,47543,47498,625
5.0,95000,0,0.225,0,47500,46920,60777,47499,579
14.0,95000,2,0.05,84,47500,47024,95000,47024,0
4.0,95000,0,0.225,0,47500,46530,65843,47498,968
12.0,95000,1,0.025,42,47500,45781,95000,45781,0
15.0,95000,1,0.05,42,47500,46764,95000,46764,0
10.0,95000,0,0.25,0,47500,46920,47602,47498,578
6.0,95000,0,0.25,0,47500,46761,50126,47495,734
8.0,95000,0,0.25,0,47500,46719,48045,47498,779
9.0,95000,0,0.25,0,47500,46743,47785,47498,755
7.0,95000,0,0.25,0,47500,46387,48710,47497,1110
14.0,95000,2,0.075,84,47500,47024,94999,47023,-1
3.0,95000,0,0.225,0,47500,45482,71849,47494,2012
13.0,95000,1,0.05,42,47500,46447,95000,46447,0
2.0,95000,0,0.25,0,47500,44873,69301,47452,2579
15.0,95000,1,0.075,42,47500,46764,95000,46764,0
14.0,95000,2,0.1,84,47500,47024,94891,46671,-353
1.0,95000,0,0.2,0,47652,47652,87757,47586,-66
12.0,95000,1,0.05,42,47500,45781,95000,45781,0
11.0,95000,1,0.025,42,47500,45990,95000,45990,0
5.0,95000,0,0.25,0,47500,46920,52437,47494,574
4.0,95000,0,0.25,0,47500,46530,55524,47491,961
15.0,95000,1,0.1,42,47500,46764,94862,46764,0
14.0,95000,2,0.125,84,47500,47024,92699,47271,247
10.0,95000,1,0.025,42,47500,46585,95000,46585,0
6.0,95000,1,0.025,42,47500,46535,95000,46535,0
8.0,95000,1,0.025,42,47500,46449,95000,46449,0
7.0,95000,1,0.025,42,47500,46197,95000,46197,0
9.0,95000,1,0.025,42,47500,46714,95000,46714,0
13.0,95000,1,0.075,42,47500,46447,95000,46447,0
2.0,95000,1,0.025,42,47500,44764,95000,44764,0
15.0,95000,1,0.125,42,47500,46764,91853,47451,687
14.0,95000,2,0.15,84,47500,47024,79904,47500,476
3.0,95000,0,0.25,0,47500,45482,60767,47484,2002
12.0,95000,1,0.075,42,47500,45781,95000,45781,0
14.0,95000,2,0.175,84,47500,47024,59694,47500,476
1.0,95000,0,0.225,0,47652,47652,82752,47519,-133
11.0,95000,1,0.05,42,47500,45990,95000,45990,0
15.0,95000,1,0.15,42,47500,46764,77343,47500,736
4.0,95000,1,0.025,42,47500,46314,95000,46314,0
5.0,95000,1,0.025,42,47500,46943,95000,46943,0
6.0,95000,1,0.05,42,47500,46535,95000,46535,0
10.0,95000,1,0.05,42,47500,46585,95000,46585,0
14.0,95000,2,0.2,84,47500,47024,49205,47500,476
13.0,95000,1,0.1,42,47500,46447,94898,46169,-278
8.0,95000,1,0.05,42,47500,46449,95000,46449,0
7.0,95000,1,0.05,42,47500,46197,95000,46197,0
2.0,95000,1,0.05,42,47500,44764,95000,44764,0
9.0,95000,1,0.05,42,47500,46714,95000,46714,0
15.0,95000,1,0.175,42,47500,46764,56764,47500,736
14.0,95000,2,0.225,84,47500,47024,47594,47500,476
12.0,95000,1,0.1,42,47500,45781,94922,45781,0
3.0,95000,1,0.025,42,47500,44724,95000,44724,0
15.0,95000,1,0.2,42,47500,46764,48530,47500,736
14.0,95000,2,0.25,84,47500,47024,47503,47500,476
11.0,95000,1,0.075,42,47500,45990,95000,45990,0
1.0,95000,0,0.25,0,47652,47652,76297,47422,-230
4.0,95000,1,0.05,42,47500,46314,95000,46314,0
6.0,95000,1,0.075,42,47500,46535,94999,46534,-1
13.0,95000,1,0.125,42,47500,46447,92874,47167,720
2.0,95000,1,0.075,42,47500,44764,94995,44753,-11
14.0,95000,3,0.025,126,47500,47210,95000,47210,0
5.0,95000,1,0.05,42,47500,46943,95000,46943,0
10.0,95000,1,0.075,42,47500,46585,95000,46585,0
15.0,95000,1,0.225,42,47500,46764,47534,47500,736
7.0,95000,1,0.075,42,47500,46197,95000,46197,0
8.0,95000,1,0.075,42,47500,46449,95000,46449,0
12.0,95000,1,0.125,42,47500,45781,93247,47123,1342
9.0,95000,1,0.075,42,47500,46714,95000,46714,0
14.0,95000,3,0.05,126,47500,47210,95000,47210,0
15.0,95000,1,0.25,42,47500,46764,47501,47500,736
3.0,95000,1,0.05,42,47500,44724,95000,44724,0
11.0,95000,1,0.1,42,47500,45990,94932,45990,0
14.0,95000,3,0.075,126,47500,47210,94997,47207,-3
13.0,95000,1,0.15,42,47500,46447,81691,47500,1053
2.0,95000,1,0.1,42,47500,44764,94956,44640,-124
4.0,95000,1,0.075,42,47500,46314,95000,46314,0
1.0,95000,1,0.025,42,47666,47666,94998,47666,0
6.0,95000,1,0.1,42,47500,46535,94979,46514,-21
15.0,95000,2,0.025,84,47500,47034,95000,47034,0
7.0,95000,1,0.1,42,47500,46197,94971,46168,-29
10.0,95000,1,0.1,42,47500,46585,94938,46493,-92
14.0,95000,3,0.1,126,47500,47210,94898,47108,-102
12.0,95000,1,0.15,42,47500,45781,83590,47500,1719
5.0,95000,1,0.075,42,47500,46943,94999,46942,-1
8.0,95000,1,0.1,42,47500,46449,94971,46420,-29
9.0,95000,1,0.1,42,47500,46714,94960,46646,-68
15.0,95000,2,0.05,84,47500,47034,95000,47034,0
14.0,95000,3,0.125,126,47500,47210,92689,47407,197
13.0,95000,1,0.175,42,47500,46447,61536,47500,1053
2.0,95000,1,0.125,42,47500,44764,94702,43882,-882
3.0,95000,1,0.075,42,47500,44724,94997,44722,-2
11.0,95000,1,0.125,42,47500,45990,93585,47162,1172
6.0,95000,1,0.125,42,47500,46535,94573,45674,-861
14.0,95000,3,0.15,126,47500,47210,79920,47500,290
15.0,95000,2,0.075,84,47500,47034,95000,47034,0
4.0,95000,1,0.1,42,47500,46314,94965,46243,-71
12.0,95000,1,0.175,42,47500,45781,63919,47500,1719
1.0,95000,1,0.05,42,47666,47666,94996,47666,0
7.0,95000,1,0.125,42,47500,46197,94440,44817,-1380
10.0,95000,1,0.125,42,47500,46585,93815,46667,82
14.0,95000,3,0.175,126,47500,47210,59576,47500,290
8.0,95000,1,0.125,42,47500,46449,94320,46325,-124
5.0,95000,1,0.1,42,47500,46943,94973,46917,-26
15.0,95000,2,0.1,84,47500,47034,94876,46714,-320
9.0,95000,1,0.125,42,47500,46714,94113,46856,142
13.0,95000,1,0.2,42,47500,46447,49943,47500,1053
14.0,95000,3,0.2,126,47500,47210,49280,47500,290
2.0,95000,1,0.15,42,47500,44764,93816,45279,515
12.0,95000,1,0.2,42,47500,45781,51019,47500,1719
15.0,95000,2,0.125,84,47500,47034,92241,47402,368
6.0,95000,1,0.15,42,47500,46535,91949,47168,633
11.0,95000,1,0.15,42,47500,45990,85399,47500,1510
14.0,95000,3,0.225,126,47500,47210,47615,47500,290
3.0,95000,1,0.1,42,47500,44724,94968,44544,-180
4.0,95000,1,0.125,42,47500,46314,94705,45705,-609
7.0,95000,1,0.15,42,47500,46197,91003,47379,1182
1.0,95000,1,0.075,42,47666,47666,94982,47666,0
14.0,95000,3,0.25,126,47500,47210,47504,47500,290
13.0,95000,1,0.225,42,47500,46447,47669,47500,1053
10.0,95000,1,0.15,42,47500,46585,87066,47500,915
15.0,95000,2,0.15,84,47500,47034,77778,47500,466
8.0,95000,1,0.15,42,47500,46449,90107,47376,927
2.0,95000,1,0.175,42,47500,44764,91394,45284,520
5.0,95000,1,0.125,42,47500,46943,94616,46374,-569
9.0,95000,1,0.15,42,47500,46714,88620,47500,786
14.0,95000,4,0.025,168,47500,46623,95000,46623,0
12.0,95000,1,0.225,42,47500,45781,47831,47500,1719
15.0,95000,2,0.175,84,47500,47034,57430,47500,466
6.0,95000,1,0.175,42,47500,46535,83293,47489,954
11.0,95000,1,0.175,42,47500,45990,67090,47500,1510
14.0,95000,4,0.05,168,47500,46623,95000,46623,0
13.0,95000,1,0.25,42,47500,46447,47502,47500,1053
3.0,95000,1,0.125,42,47500,44724,94737,45507,783
7.0,95000,1,0.175,42,47500,46197,80166,47500,1303
4.0,95000,1,0.15,42,47500,46314,93185,46723,409
15.0,95000,2,0.2,84,47500,47034,48629,47500,466
14.0,95000,4,0.075,168,47500,46623,94996,46623,0
10.0,95000,1,0.175,42,47500,46585,70335,47500,915
12.0,95000,1,0.25,42,47500,45781,47518,47499,1718
1.0,95000,1,0.1,42,47666,47666,94895,47666,0
2.0,95000,1,0.2,42,47500,44764,85495,47231,2467
8.0,95000,1,0.175,42,47500,46449,76854,47500,1051
15.0,95000,2,0.225,84,47500,47034,47542,47500,466
5.0,95000,1,0.15,42,47500,46943,92558,46832,-111
14.0,95000,4,0.1,168,47500,46623,94918,46623,0
9.0,95000,1,0.175,42,47500,46714,73795,47500,786
6.0,95000,1,0.2,42,47500,46535,68782,47499,964
13.0,95000,2,0.025,84,47500,46497,95000,46497,0
11.0,95000,1,0.2,42,47500,45990,52713,47500,1510
14.0,95000,4,0.125,168,47500,46623,92698,47315,692
15.0,95000,2,0.25,84,47500,47034,47500,47500,466
7.0,95000,1,0.2,42,47500,46197,64716,47500,1303
4.0,95000,1,0.175,42,47500,46314,88088,47417,1103
12.0,95000,2,0.025,84,47500,46704,95000,46704,0
3.0,95000,1,0.15,42,47500,44724,93585,45513,789
10.0,95000,1,0.2,42,47500,46585,54606,47500,915
14.0,95000,4,0.15,168,47500,46623,79741,47500,877
2.0,95000,1,0.225,42,47500,44764,77559,47455,2691
15.0,95000,3,0.025,126,47500,46327,95000,46327,0
8.0,95000,1,0.2,42,47500,46449,60875,47500,1051
1.0,95000,1,0.125,42,47666,47666,94505,47656,-10
14.0,95000,4,0.175,168,47500,46623,59451,47500,877
13.0,95000,2,0.05,84,47500,46497,95000,46497,0
6.0,95000,1,0.225,42,47500,46535,56167,47498,963
9.0,95000,1,0.2,42,47500,46714,57444,47500,786
5.0,95000,1,0.175,42,47500,46943,85788,47492,549
11.0,95000,1,0.225,42,47500,45990,48124,47500,1510
15.0,95000,3,0.05,126,47500,46327,95000,46327,0
7.0,95000,1,0.225,42,47500,46197,53102,47499,1302
14.0,95000,4,0.2,168,47500,46623,49194,47500,877
12.0,95000,2,0.05,84,47500,46704,95000,46704,0
4.0,95000,1,0.2,42,47500,46314,77850,47500,1186
10.0,95000,1,0.225,42,47500,46585,48618,47500,915
2.0,95000,1,0.25,42,47500,44764,68867,47468,2704
14.0,95000,4,0.225,168,47500,46623,47577,47500,877
15.0,95000,3,0.075,126,47500,46327,94999,46326,-1
3.0,95000,1,0.175,42,47500,44724,89542,47144,2420
8.0,95000,1,0.225,42,47500,46449,50893,47500,1051
13.0,95000,2,0.075,84,47500,46497,95000,46497,0
6.0,95000,1,0.25,42,47500,46535,49944,47497,962
14.0,95000,4,0.25,168,47500,46623,47504,47500,877
11.0,95000,1,0.25,42,47500,45990,47544,47500,1510
9.0,95000,1,0.225,42,47500,46714,49448,47500,786
15.0,95000,3,0.1,126,47500,46327,94880,46045,-282
1.0,95000,1,0.15,42,47666,47666,93401,47638,-28
7.0,95000,1,0.25,42,47500,46197,48629,47498,1301
5.0,95000,1,0.2,42,47500,46943,73285,47500,557
12.0,95000,2,0.075,84,47500,46704,94999,46703,-1
14.0,95000,5,0.025,210,47500,47030,95000,47030,0
10.0,95000,1,0.25,42,47500,46585,47590,47499,914
4.0,95000,1,0.225,42,47500,46314,65583,47498,1184
15.0,95000,3,0.125,126,47500,46327,92239,47452,1125
2.0,95000,2,0.025,84,47501,45155,95000,45155,0
14.0,95000,5,0.05,210,47500,47030,95000,47030,0
13.0,95000,2,0.1,84,47500,46497,94914,46324,-173
3.0,95000,1,0.2,42,47500,44724,82465,47486,2762
8.0,95000,1,0.25,42,47500,46449,48053,47496,1047
6.0,95000,2,0.025,84,47500,46665,95000,46665,0
15.0,95000,3,0.15,126,47500,46327,77862,47500,1173
11.0,95000,2,0.025,84,47500,45980,95000,45980,0
9.0,95000,1,0.25,42,47500,46714,47752,47498,784
12.0,95000,2,0.1,84,47500,46704,94926,46469,-235
14.0,95000,5,0.075,210,47500,47030,94999,47029,-1
7.0,95000,2,0.025,84,47500,46355,95000,46355,0
5.0,95000,1,0.225,42,47500,46943,60271,47498,555
1.0,95000,1,0.175,42,47666,47666,92101,47641,-25
15.0,95000,3,0.175,126,47500,46327,57359,47500,1173
14.0,95000,5,0.1,210,47500,47030,94910,46843,-187
10.0,95000,2,0.025,84,47500,46686,95000,46686,0
4.0,95000,1,0.25,42,47500,46314,55179,47490,1176
2.0,95000,2,0.05,84,47501,45155,95000,45155,0
13.0,95000,2,0.125,84,47500,46497,93129,47332,835
15.0,95000,3,0.2,126,47500,46327,48707,47500,1173
6.0,95000,2,0.05,84,47500,46665,95000,46665,0
3.0,95000,1,0.225,42,47500,44724,71520,47496,2772
8.0,95000,2,0.025,84,47500,46539,95000,46539,0
12.0,95000,2,0.125,84,47500,46704,93484,47031,327
11.0,95000,2,0.05,84,47500,45980,95000,45980,0
14.0,95000,5,0.125,210,47500,47030,92948,47500,470
9.0,95000,2,0.025,84,47500,46387,95000,46387,0
7.0,95000,2,0.05,84,47500,46355,95000,46355,0
15.0,95000,3,0.225,126,47500,46327,47560,47500,1173
5.0,95000,1,0.25,42,47500,46943,52074,47496,553
10.0,95000,2,0.05,84,47500,46686,95000,46686,0
13.0,95000,2,0.15,84,47500,46497,82079,47500,1003
1.0,95000,1,0.2,42,47666,47666,87838,47586,-80
4.0,95000,2,0.025,84,47500,46253,95000,46253,0
15.0,95000,3,0.25,126,47500,46327,47503,47500,1173
2.0,95000,2,0.075,84,47501,45155,94996,45155,0
14.0,95000,5,0.15,210,47500,47030,80585,47500,470
12.0,95000,2,0.15,84,47500,46704,84042,47500,796
6.0,95000,2,0.075,84,47500,46665,94998,46663,-2
3.0,95000,1,0.25,42,47500,44724,61767,47494,2770
11.0,95000,2,0.075,84,47500,45980,94999,45980,0
15.0,95000,4,0.025,168,47500,46984,95000,46984,0
8.0,95000,2,0.05,84,47500,46539,95000,46539,0
7.0,95000,2,0.075,84,47500,46355,94998,46353,-2
9.0,95000,2,0.05,84,47500,46387,95000,46387,0
5.0,95000,2,0.025,84,47500,46745,95000,46745,0
13.0,95000,2,0.175,84,47500,46497,62233,47500,1003
14.0,95000,5,0.175,210,47500,47030,59810,47500,470
15.0,95000,4,0.05,168,47500,46984,95000,46984,0
10.0,95000,2,0.075,84,47500,46686,94999,46685,-1
4.0,95000,2,0.05,84,47500,46253,95000,46253,0
2.0,95000,2,0.1,84,47501,45155,94963,45155,0
12.0,95000,2,0.175,84,47500,46704,64670,47500,796
1.0,95000,1,0.225,42,47666,47666,82854,47516,-150
6.0,95000,2,0.1,84,47500,46665,94980,46646,-19
15.0,95000,4,0.075,168,47500,46984,94997,46984,0
11.0,95000,2,0.1,84,47500,45980,94937,45980,0
14.0,95000,5,0.2,210,47500,47030,49318,47500,470
3.0,95000,2,0.025,84,47500,44890,95000,44890,0
8.0,95000,2,0.075,84,47500,46539,94998,46537,-2
7.0,95000,2,0.1,84,47500,46355,94978,46335,-20
13.0,95000,2,0.2,84,47500,46497,50122,47500,1003
9.0,95000,2,0.075,84,47500,46387,94999,46386,-1
15.0,95000,4,0.1,168,47500,46984,94882,46984,0
5.0,95000,2,0.05,84,47500,46745,95000,46745,0
10.0,95000,2,0.1,84,47500,46686,94945,46602,-84
14.0,95000,5,0.225,210,47500,47030,47602,47500,470
12.0,95000,2,0.2,84,47500,46704,51318,47500,796
2.0,95000,2,0.125,84,47501,45155,94761,45160,5
4.0,95000,2,0.075,84,47500,46253,94999,46252,-1
15.0,95000,4,0.125,168,47500,46984,92143,47403,419
6.0,95000,2,0.125,84,47500,46665,94629,46203,-462
1.0,95000,1,0.25,42,47666,47666,76458,47432,-234
11.0,95000,2,0.125,84,47500,45980,93757,47014,1034
13.0,95000,2,0.225,84,47500,46497,47688,47500,1003
3.0,95000,2,0.05,84,47500,44890,95000,44890,0
7.0,95000,2,0.125,84,47500,46355,94498,45276,-1079
14.0,95000,5,0.25,210,47500,47030,47502,47500,470
15.0,95000,4,0.15,168,47500,46984,77516,47500,516
8.0,95000,2,0.1,84,47500,46539,94966,46507,-32
9.0,95000,2,0.1,84,47500,46387,94960,46320,-67
5.0,95000,2,0.075,84,47500,46745,94999,46744,-1
12.0,95000,2,0.225,84,47500,46704,47875,47500,796
10.0,95000,2,0.125,84,47500,46686,93997,46818,132
15.0,95000,4,0.175,168,47500,46984,57226,47500,516
4.0,95000,2,0.1,84,47500,46253,94978,46195,-58
14.0,95000,6,0.025,252,47500,45737,95000,45737,0
2.0,95000,2,0.15,84,47501,45155,93753,47180,2025
6.0,95000,2,0.15,84,47500,46665,92093,47271,606
13.0,95000,2,0.25,84,47500,46497,47503,47500,1003
15.0,95000,4,0.2,168,47500,46984,48591,47500,516
11.0,95000,2,0.15,84,47500,45980,85862,47500,1520
3.0,95000,2,0.075,84,47500,44890,94999,44889,-1
7.0,95000,2,0.15,84,47500,46355,91250,47435,1080
8.0,95000,2,0.125,84,47500,46539,94357,44940,-1599
1.0,95000,2,0.025,84,47696,47696,95000,47696,0
12.0,95000,2,0.25,84,47500,46704,47518,47500,796
15.0,95000,4,0.225,168,47500,46984,47551,47500,516
9.0,95000,2,0.125,84,47500,46387,94272,46604,217
5.0,95000,2,0.1,84,47500,46745,94984,46717,-28
14.0,95000,6,0.05,252,47500,45737,95000,45737,0
10.0,95000,2,0.15,84,47500,46686,87461,47500,814
15.0,95000,4,0.25,168,47500,46984,47500,47500,516
4.0,95000,2,0.125,84,47500,46253,94722,45483,-770
6.0,95000,2,0.175,84,47500,46665,83742,47500,835
13.0,95000,3,0.025,126,47500,46567,95000,46567,0
2.0,95000,2,0.175,84,47501,45155,91555,47179,2024
11.0,95000,2,0.175,84,47500,45980,67957,47500,1520
14.0,95000,6,0.075,252,47500,45737,94998,45737,0
3.0,95000,2,0.1,84,47500,44890,94966,44842,-48
7.0,95000,2,0.175,84,47500,46355,80866,47500,1145
15.0,95000,5,0.025,210,47500,46991,95000,46991,0
5.0,95000,2,0.125,84,47500,46745,94691,46242,-503
8.0,95000,2,0.15,84,47500,46539,90097,47481,942
12.0,95000,3,0.025,126,47500,47030,95000,47030,0
9.0,95000,2,0.15,84,47500,46387,88810,47500,1113
10.0,95000,2,0.175,84,47500,46686,70991,47500,814
15.0,95000,5,0.05,210,47500,46991,95000,46991,0
14.0,95000,6,0.1,252,47500,45737,94918,45737,0
1.0,95000,2,0.05,84,47696,47696,94997,47696,0
4.0,95000,2,0.15,84,47500,46253,93173,45972,-281
6.0,95000,2,0.2,84,47500,46665,69373,47499,834
13.0,95000,3,0.05,126,47500,46567,95000,46567,0
11.0,95000,2,0.2,84,47500,45980,52921,47499,1519
3.0,95000,2,0.125,84,47500,44890,94762,44034,-856
7.0,95000,2,0.2,84,47500,46355,64828,47499,1144
15.0,95000,5,0.075,210,47500,46991,94999,46990,-1
2.0,95000,2,0.2,84,47501,45155,85927,47454,2299
5.0,95000,2,0.15,84,47500,46745,92712,46944,199
8.0,95000,2,0.175,84,47500,46539,77720,47500,961
14.0,95000,6,0.125,252,47500,45737,92917,47272,1535
12.0,95000,3,0.05,126,47500,47030,95000,47030,0
9.0,95000,2,0.175,84,47500,46387,74682,47500,1113
15.0,95000,5,0.1,210,47500,46991,94872,46601,-390
10.0,95000,2,0.2,84,47500,46686,55089,47500,814
3.0,95000,2,0.15,84,47500,44890,93672,44798,-92
6.0,95000,2,0.225,84,47500,46665,56520,47498,833
5.0,95000,2,0.175,84,47500,46745,86306,47491,746
11.0,95000,2,0.225,84,47500,45980,48208,47500,1520
4.0,95000,2,0.175,84,47500,46253,88547,47390,1137
13.0,95000,3,0.075,126,47500,46567,94998,46565,-2
7.0,95000,2,0.225,84,47500,46355,53501,47499,1144
15.0,95000,5,0.125,210,47500,46991,92468,47500,509
14.0,95000,6,0.15,252,47500,45737,80281,47500,1763
1.0,95000,2,0.075,84,47696,47696,94983,47694,-2
2.0,95000,2,0.225,84,47501,45155,78287,47479,2324
3.0,95000,2,0.175,84,47500,44890,89834,47076,2186
8.0,95000,2,0.2,84,47500,46539,60992,47500,961
10.0,95000,2,0.225,84,47500,46686,48752,47500,814
5.0,95000,2,0.2,84,47500,46745,73935,47500,755
9.0,95000,2,0.2,84,47500,46387,57995,47500,1113
15.0,95000,5,0.15,210,47500,46991,78402,47500,509
12.0,95000,3,0.075,126,47500,47030,94999,47029,-1
11.0,95000,2,0.25,84,47500,45980,47541,47500,1520
14.0,95000,6,0.175,252,47500,45737,59750,47500,1763
15.0,95000,5,0.175,210,47500,46991,57536,47500,509
15.0,95000,5,0.2,210,47500,46991,48655,47500,509
15.0,95000,5,0.225,210,47500,46991,47550,47500,509
15.0,95000,5,0.25,210,47500,46991,47501,47500,509
15.0,95000,6,0.025,252,47500,46556,95000,46556,0
15.0,95000,6,0.05,252,47500,46556,95000,46556,0
7.0,95000,2,0.25,84,47500,46355,48651,47496,1141
14.0,95000,6,0.2,252,47500,45737,49342,47500,1763
8.0,95000,2,0.225,84,47500,46539,51198,47499,960
11.0,95000,3,0.025,126,47500,46801,95000,46801,0
12.0,95000,3,0.1,126,47500,47030,94934,46964,-66
13.0,95000,3,0.1,126,47500,46567,94914,46482,-85
4.0,95000,2,0.2,84,47500,46253,78358,47497,1244
15.0,95000,6,0.075,252,47500,46556,95000,46556,0
3.0,95000,2,0.2,84,47500,44890,82375,47477,2587
10.0,95000,2,0.25,84,47500,46686,47596,47500,814
2.0,95000,2,0.25,84,47501,45155,69554,47457,2302
6.0,95000,2,0.25,84,47500,46665,50086,47495,830
9.0,95000,2,0.225,84,47500,46387,49668,47500,1113
1.0,95000,2,0.1,84,47696,47696,94898,47692,-4
5.0,95000,2,0.225,84,47500,46745,60859,47498,753
20.0,95000,0,0.025,0,47500,46522,95000,46522,0
14.0,95000,6,0.225,252,47500,45737,47597,47500,1763
20.0,95000,0,0.025,0,47500,46522,95000,46522,0
8.0,95000,2,0.25,84,47500,46539,48008,47499,960
7.0,95000,3,0.025,126,47500,46531,95000,46531,0
11.0,95000,3,0.05,126,47500,46801,95000,46801,0
13.0,95000,3,0.125,126,47500,46567,93090,47374,807
4.0,95000,2,0.225,84,47500,46253,65989,47498,1245
12.0,95000,3,0.125,126,47500,47030,93446,46797,-233
15.0,95000,6,0.1,252,47500,46556,94901,46929,373
3.0,95000,2,0.225,84,47500,44890,71963,47495,2605
30.0,95000,0,0.025,0,47500,46645,95000,46645,0
2.0,95000,3,0.025,126,47500,44849,95000,44849,0
10.0,95000,3,0.025,126,47500,46893,95000,46893,0
14.0,95000,6,0.25,252,47500,45737,47508,47500,1763
20.0,95000,0,0.05,0,47500,46522,95000,46522,0
9.0,95000,2,0.25,84,47500,46387,47754,47498,1111
6.0,95000,3,0.025,126,47500,46394,95000,46394,0
8.0,95000,3,0.025,126,47500,46350,95000,46350,0
20.0,95000,0,0.05,0,47500,46522,95000,46522,0
7.0,95000,3,0.05,126,47500,46531,95000,46531,0
11.0,95000,3,0.075,126,47500,46801,94999,46800,-1
4.0,95000,2,0.25,84,47500,46253,55451,47489,1236
5.0,95000,2,0.25,84,47500,46745,52411,47496,751
12.0,95000,3,0.15,126,47500,47030,84056,47500,470
15.0,95000,6,0.125,252,47500,46556,92328,47407,851
3.0,95000,2,0.25,84,47500,44890,60819,47477,2587
1.0,95000,2,0.125,84,47696,47696,94567,47683,-13
13.0,95000,3,0.15,126,47500,46567,82148,47500,933
2.0,95000,3,0.05,126,47500,44849,95000,44849,0
10.0,95000,3,0.05,126,47500,46893,95000,46893,0
14.0,95000,7,0.025,294,47500,46886,95000,46886,0
20.0,95000,0,0.075,0,47500,46522,94999,46521,-1
8.0,95000,3,0.05,126,47500,46350,95000,46350,0
20.0,95000,0,0.075,0,47500,46522,94999,46521,-1
7.0,95000,3,0.075,126,47500,46531,95000,46531,0
11.0,95000,3,0.1,126,47500,46801,94947,46748,-53
4.0,95000,3,0.025,126,47500,46132,95000,46132,0
12.0,95000,3,0.175,126,47500,47030,64601,47500,470
15.0,95000,6,0.15,252,47500,46556,77970,47500,944
6.0,95000,3,0.05,126,47500,46394,95000,46394,0
3.0,95000,3,0.025,126,47500,44898,95000,44898,0
9.0,95000,3,0.025,126,47500,46735,95000,46735,0
5.0,95000,3,0.025,126,47500,45453,95000,45453,0
14.0,95000,7,0.05,294,47500,46886,95000,46886,0
20.0,95000,0,0.1,0,47500,46522,94735,47058,536
2.0,95000,3,0.075,126,47500,44849,95000,44849,0
1.0,95000,2,0.15,84,47696,47696,93527,47667,-29
8.0,95000,3,0.075,126,47500,46350,95000,46350,0
20.0,95000,0,0.1,0,47500,46522,94735,47058,536
7.0,95000,3,0.1,126,47500,46531,94978,46489,-42
10.0,95000,3,0.075,126,47500,46893,95000,46893,0
13.0,95000,3,0.175,126,47500,46567,62092,47500,933
11.0,95000,3,0.125,126,47500,46801,93693,46437,-364
12.0,95000,3,0.2,126,47500,47030,51379,47500,470
15.0,95000,6,0.175,252,47500,46556,57363,47500,944
4.0,95000,3,0.05,126,47500,46132,95000,46132,0
3.0,95000,3,0.05,126,47500,44898,95000,44898,0
6.0,95000,3,0.075,126,47500,46394,95000,46394,0
20.0,95000,0,0.125,0,47500,46522,88796,47500,978
14.0,95000,7,0.075,294,47500,46886,94998,46884,-2
8.0,95000,3,0.1,126,47500,46350,94971,46297,-53
20.0,95000,0,0.125,0,47500,46522,88796,47500,978
7.0,95000,3,0.125,126,47500,46531,94499,45242,-1289
9.0,95000,3,0.05,126,47500,46735,95000,46735,0
11.0,95000,3,0.15,126,47500,46801,85826,47500,699
2.0,95000,3,0.1,126,47500,44849,94963,44752,-97
12.0,95000,3,0.225,126,47500,47030,47893,47500,470
15.0,95000,6,0.2,252,47500,46556,48688,47500,944
5.0,95000,3,0.05,126,47500,45453,95000,45453,0
4.0,95000,3,0.075,126,47500,46132,95000,46132,0
10.0,95000,3,0.1,126,47500,46893,94955,46786,-107
3.0,95000,3,0.075,126,47500,44898,95000,44898,0
1.0,95000,2,0.175,84,47696,47696,92232,47658,-38
13.0,95000,3,0.2,126,47500,46567,50126,47500,933
20.0,95000,0,0.15,0,47500,46522,67153,47500,978
14.0,95000,7,0.1,294,47500,46886,94886,46774,-112
20.0,95000,0,0.15,0,47500,46522,67153,47500,978
8.0,95000,3,0.125,126,47500,46350,94343,45930,-420
7.0,95000,3,0.15,126,47500,46531,91182,47308,777
15.0,95000,6,0.225,252,47500,46556,47559,47500,944
12.0,95000,3,0.25,126,47500,47030,47526,47500,470
11.0,95000,3,0.175,126,47500,46801,67923,47500,699
6.0,95000,3,0.1,126,47500,46394,94985,46381,-13
4.0,95000,3,0.1,126,47500,46132,94977,46075,-57
2.0,95000,3,0.125,126,47500,44849,94727,44214,-635
3.0,95000,3,0.1,126,47500,44898,94980,44837,-61
10.0,95000,3,0.125,126,47500,46893,93956,46529,-364
9.0,95000,3,0.075,126,47500,46735,95000,46735,0
20.0,95000,0,0.175,0,47500,46522,50551,47500,978
20.0,95000,0,0.175,0,47500,46522,50551,47500,978
5.0,95000,3,0.075,126,47500,45453,95000,45453,0
14.0,95000,7,0.125,294,47500,46886,92296,47408,522
8.0,95000,3,0.15,126,47500,46350,90051,47419,1069
7.0,95000,3,0.175,126,47500,46531,80948,47500,969
15.0,95000,6,0.25,252,47500,46556,47502,47500,944
13.0,95000,3,0.225,126,47500,46567,47714,47500,933
12.0,95000,4,0.025,168,47500,46128,95000,46128,0
11.0,95000,3,0.2,126,47500,46801,52904,47500,699
1.0,95000,2,0.2,84,47696,47696,88059,47621,-75
4.0,95000,3,0.125,126,47500,46132,94746,45729,-403
3.0,95000,3,0.125,126,47500,44898,94761,43713,-1185
2.0,95000,3,0.15,126,47500,44849,93933,45449,600
6.0,95000,3,0.125,126,47500,46394,94643,45807,-587
20.0,95000,0,0.2,0,47500,46522,47605,47500,978
20.0,95000,0,0.2,0,47500,46522,47605,47500,978
9.0,95000,3,0.1,126,47500,46735,94972,46709,-26
10.0,95000,3,0.15,126,47500,46893,87463,47500,607
14.0,95000,7,0.15,294,47500,46886,78767,47500,614
8.0,95000,3,0.175,126,47500,46350,77647,47500,1150
7.0,95000,3,0.2,126,47500,46531,64663,47500,969
15.0,95000,7,0.025,294,47500,46620,95000,46620,0
11.0,95000,3,0.225,126,47500,46801,48232,47500,699
12.0,95000,4,0.05,168,47500,46128,95000,46128,0
5.0,95000,3,0.1,126,47500,45453,94982,45453,0
4.0,95000,3,0.15,126,47500,46132,93290,46406,274
13.0,95000,3,0.25,126,47500,46567,47515,47500,933
20.0,95000,0,0.225,0,47500,46522,47501,47500,978
20.0,95000,0,0.225,0,47500,46522,47501,47500,978
3.0,95000,3,0.15,126,47500,44898,93631,45561,663
14.0,95000,7,0.175,294,47500,46886,58815,47500,614
8.0,95000,3,0.2,126,47500,46350,60884,47500,1150
7.0,95000,3,0.225,126,47500,46531,53469,47500,969
1.0,95000,2,0.225,84,47696,47696,83223,47555,-141
9.0,95000,3,0.125,126,47500,46735,94206,45967,-768
2.0,95000,3,0.175,126,47500,44849,91584,45458,609
11.0,95000,3,0.25,126,47500,46801,47555,47500,699
15.0,95000,7,0.05,294,47500,46620,95000,46620,0
10.0,95000,3,0.175,126,47500,46893,70960,47500,607
6.0,95000,3,0.15,126,47500,46394,92095,47121,727
12.0,95000,4,0.075,168,47500,46128,94997,46128,0
20.0,95000,0,0.25,0,47500,46522,47500,47500,978
4.0,95000,3,0.175,126,47500,46132,88558,47400,1268
20.0,95000,0,0.25,0,47500,46522,47500,47500,978
3.0,95000,3,0.175,126,47500,44898,89842,47122,2224
7.0,95000,3,0.25,126,47500,46531,48654,47499,968
8.0,95000,3,0.225,126,47500,46350,51259,47500,1150
14.0,95000,7,0.2,294,47500,46886,49022,47500,614
5.0,95000,3,0.125,126,47500,45453,94713,45453,0
11.0,95000,4,0.025,168,47500,46951,95000,46951,0
9.0,95000,3,0.15,126,47500,46735,88805,47477,742
13.0,95000,4,0.025,168,47500,46267,95000,46267,0
15.0,95000,7,0.075,294,47500,46620,94999,46619,-1
12.0,95000,4,0.1,168,47500,46128,94930,46128,0
2.0,95000,3,0.2,126,47500,44849,85815,47193,2344
10.0,95000,3,0.2,126,47500,46893,55012,47500,607
1.0,95000,2,0.25,84,47696,47696,76777,47479,-217
20.0,95000,1,0.025,42,47500,47054,95000,47054,0
4.0,95000,3,0.2,126,47500,46132,78435,47498,1366
6.0,95000,3,0.175,126,47500,46394,83970,47489,1095
20.0,95000,1,0.025,42,47500,47054,95000,47054,0
8.0,95000,3,0.25,126,47500,46350,48050,47499,1149
14.0,95000,7,0.225,294,47500,46886,47587,47500,614
7.0,95000,4,0.025,168,47500,46607,95000,46607,0
3.0,95000,3,0.2,126,47500,44898,82525,47486,2588
11.0,95000,4,0.05,168,47500,46951,95000,46951,0
15.0,95000,7,0.1,294,47500,46620,94859,46374,-246
12.0,95000,4,0.125,168,47500,46128,93427,47231,1103
9.0,95000,3,0.175,126,47500,46735,74654,47500,765
5.0,95000,3,0.15,126,47500,45453,92730,46854,1401
2.0,95000,3,0.225,126,47500,44849,78142,47448,2599
10.0,95000,3,0.225,126,47500,46893,48837,47500,607
20.0,95000,1,0.05,42,47500,47054,95000,47054,0
13.0,95000,4,0.05,168,47500,46267,95000,46267,0
4.0,95000,3,0.225,126,47500,46132,65894,47496,1364
20.0,95000,1,0.05,42,47500,47054,95000,47054,0
14.0,95000,7,0.25,294,47500,46886,47501,47500,614
8.0,95000,4,0.025,168,47500,46767,95000,46767,0
7.0,95000,4,0.05,168,47500,46607,95000,46607,0
3.0,95000,3,0.225,126,47500,44898,71993,47491,2593
11.0,95000,4,0.075,168,47500,46951,94997,46948,-3
6.0,95000,3,0.2,126,47500,46394,69531,47500,1106
12.0,95000,4,0.15,168,47500,46128,83792,47500,1372
1.0,95000,3,0.025,126,47672,47672,94999,47672,0
15.0,95000,7,0.125,294,47500,46620,91617,47452,832
9.0,95000,3,0.2,126,47500,46735,57954,47500,765
20.0,95000,1,0.075,42,47500,47054,95000,47054,0
4.0,95000,3,0.25,126,47500,46132,55402,47483,1351
10.0,95000,3,0.25,126,47500,46893,47618,47498,605
14.0,95000,8,0.025,336,47500,46821,95000,46821,0
20.0,95000,1,0.075,42,47500,47054,95000,47054,0
13.0,95000,4,0.075,168,47500,46267,94998,46085,-182
2.0,95000,3,0.25,126,47500,44849,69300,47456,2607
8.0,95000,4,0.05,168,47500,46767,95000,46767,0
7.0,95000,4,0.075,168,47500,46607,94998,46605,-2
11.0,95000,4,0.1,168,47500,46951,94932,46884,-67
3.0,95000,3,0.25,126,47500,44898,60655,47471,2573
5.0,95000,3,0.175,126,47500,45453,86262,47474,2021
12.0,95000,4,0.175,168,47500,46128,64217,47500,1372
15.0,95000,7,0.15,294,47500,46620,76468,47500,880
9.0,95000,3,0.225,126,47500,46735,49762,47500,765
6.0,95000,3,0.225,126,47500,46394,56545,47500,1106
20.0,95000,1,0.1,42,47500,47054,94642,47054,0
4.0,95000,4,0.025,168,47500,46562,95000,46562,0
14.0,95000,8,0.05,336,47500,46821,95000,46821,0
20.0,95000,1,0.1,42,47500,47054,94642,47054,0
1.0,95000,3,0.05,126,47672,47672,94995,47672,0
8.0,95000,4,0.075,168,47500,46767,95000,46767,0
7.0,95000,4,0.1,168,47500,46607,94970,46557,-50
13.0,95000,4,0.1,168,47500,46267,94922,46891,624
11.0,95000,4,0.125,168,47500,46951,93704,46871,-80
10.0,95000,4,0.025,168,47500,46480,95000,46480,0
2.0,95000,4,0.025,168,47500,45288,95000,45288,0
12.0,95000,4,0.2,168,47500,46128,51209,47500,1372
3.0,95000,4,0.025,168,47500,45715,95000,45715,0
15.0,95000,7,0.175,294,47500,46620,56575,47500,880
9.0,95000,3,0.25,126,47500,46735,47800,47498,763
5.0,95000,3,0.2,126,47500,45453,73800,47500,2047
20.0,95000,1,0.125,42,47500,47054,88113,47500,446
14.0,95000,8,0.075,336,47500,46821,94999,46820,-1
4.0,95000,4,0.05,168,47500,46562,95000,46562,0
6.0,95000,3,0.25,126,47500,46394,50108,47497,1103
20.0,95000,1,0.125,42,47500,47054,88113,47500,446
8.0,95000,4,0.1,168,47500,46767,94966,46734,-33
7.0,95000,4,0.125,168,47500,46607,94465,45795,-812
11.0,95000,4,0.15,168,47500,46951,85592,47500,549
12.0,95000,4,0.225,168,47500,46128,47837,47500,1372
13.0,95000,4,0.125,168,47500,46267,93108,47294,1027
15.0,95000,7,0.2,294,47500,46620,48483,47500,880
3.0,95000,4,0.05,168,47500,45715,95000,45715,0
10.0,95000,4,0.05,168,47500,46480,95000,46480,0
1.0,95000,3,0.075,126,47672,47672,94973,47670,-2
2.0,95000,4,0.05,168,47500,45288,95000,45288,0
20.0,95000,1,0.15,42,47500,47054,66224,47500,446
9.0,95000,4,0.025,168,47500,46219,95000,46219,0
14.0,95000,8,0.1,336,47500,46821,94894,46718,-103
20.0,95000,1,0.15,42,47500,47054,66224,47500,446
12.0,95000,4,0.25,168,47500,46128,47520,47500,1372
4.0,95000,4,0.075,168,47500,46562,94998,46560,-2
8.0,95000,4,0.125,168,47500,46767,94345,46853,86
11.0,95000,4,0.175,168,47500,46951,67545,47500,549
7.0,95000,4,0.15,168,47500,46607,91139,47395,788
15.0,95000,7,0.225,294,47500,46620,47543,47500,880
5.0,95000,3,0.225,126,47500,45453,60824,47498,2045
6.0,95000,4,0.025,168,47500,46792,95000,46792,0
13.0,95000,4,0.15,168,47500,46267,81729,47500,1233
3.0,95000,4,0.075,168,47500,45715,94995,45704,-11
10.0,95000,4,0.075,168,47500,46480,94999,46479,-1
20.0,95000,1,0.175,42,47500,47054,49995,47500,446
2.0,95000,4,0.075,168,47500,45288,94994,45283,-5
14.0,95000,8,0.125,336,47500,46821,92530,47321,500
20.0,95000,1,0.175,42,47500,47054,49995,47500,446
11.0,95000,4,0.2,168,47500,46951,52781,47500,549
12.0,95000,5,0.025,210,47500,46997,95000,46997,0
8.0,95000,4,0.15,168,47500,46767,89971,47417,650
7.0,95000,4,0.175,168,47500,46607,80487,47500,893
4.0,95000,4,0.1,168,47500,46562,94964,46527,-35
1.0,95000,3,0.1,126,47672,47672,94885,47670,-2
15.0,95000,7,0.25,294,47500,46620,47501,47500,880
9.0,95000,4,0.05,168,47500,46219,95000,46219,0
3.0,95000,4,0.1,168,47500,45715,94966,45624,-91
13.0,95000,4,0.175,168,47500,46267,61764,47500,1233
20.0,95000,1,0.2,42,47500,47054,47600,47500,446
5.0,95000,3,0.25,126,47500,45453,52228,47493,2040
10.0,95000,4,0.1,168,47500,46480,94936,46257,-223
11.0,95000,4,0.225,168,47500,46951,48120,47500,549
20.0,95000,1,0.2,42,47500,47054,47600,47500,446
14.0,95000,8,0.15,336,47500,46821,79101,47500,679
6.0,95000,4,0.05,168,47500,46792,95000,46792,0
12.0,95000,5,0.05,210,47500,46997,95000,46997,0
8.0,95000,4,0.175,168,47500,46767,77221,47500,733
7.0,95000,4,0.2,168,47500,46607,65143,47500,893
4.0,95000,4,0.125,168,47500,46562,94695,46029,-533
15.0,95000,8,0.025,336,47500,45915,95000,45915,0
2.0,95000,4,0.1,168,47500,45288,94954,45184,-104
20.0,95000,1,0.225,42,47500,47054,47500,47500,446
3.0,95000,4,0.125,168,47500,45715,94736,45072,-643
1.0,95000,3,0.125,126,47672,47672,94512,47668,-4
9.0,95000,4,0.075,168,47500,46219,94999,46218,-1
13.0,95000,4,0.2,168,47500,46267,50098,47500,1233
11.0,95000,4,0.25,168,47500,46951,47538,47499,548
20.0,95000,1,0.225,42,47500,47054,47500,47500,446
14.0,95000,8,0.175,336,47500,46821,58637,47500,679
12.0,95000,5,0.075,210,47500,46997,94999,46996,-1
8.0,95000,4,0.2,168,47500,46767,60697,47500,733
7.0,95000,4,0.225,168,47500,46607,53315,47500,893
15.0,95000,8,0.05,336,47500,45915,95000,45915,0
10.0,95000,4,0.125,168,47500,46480,93969,46561,81
4.0,95000,4,0.15,168,47500,46562,93236,46556,-6
5.0,95000,4,0.025,168,47500,45829,95000,45829,0
6.0,95000,4,0.075,168,47500,46792,94998,46790,-2
20.0,95000,1,0.25,42,47500,47054,47500,47500,446
2.0,95000,4,0.125,168,47500,45288,94713,44690,-598
3.0,95000,4,0.15,168,47500,45715,93623,45285,-430
11.0,95000,5,0.025,210,47500,47119,95000,47119,0
13.0,95000,4,0.225,168,47500,46267,47682,47500,1233
20.0,95000,1,0.25,42,47500,47054,47500,47500,446
14.0,95000,8,0.2,336,47500,46821,49049,47500,679
7.0,95000,4,0.25,168,47500,46607,48563,47500,893
8.0,95000,4,0.225,168,47500,46767,51048,47500,733
12.0,95000,5,0.1,210,47500,46997,94937,46854,-143
15.0,95000,8,0.075,336,47500,45915,94998,45913,-2
9.0,95000,4,0.1,168,47500,46219,94961,46181,-38
1.0,95000,3,0.15,126,47672,47672,93467,47652,-20
4.0,95000,4,0.175,168,47500,46562,88432,47437,875
10.0,95000,4,0.15,168,47500,46480,87244,47500,1020
20.0,95000,2,0.025,84,47500,47058,95000,47058,0
14.0,95000,8,0.225,336,47500,46821,47579,47500,679
11.0,95000,5,0.05,210,47500,47119,95000,47119,0
5.0,95000,4,0.05,168,47500,45829,95000,45829,0
3.0,95000,4,0.175,168,47500,45715,89720,47140,1425
20.0,95000,2,0.025,84,47500,47058,95000,47058,0
2.0,95000,4,0.15,168,47500,45288,93851,45398,110
6.0,95000,4,0.1,168,47500,46792,94970,46762,-30
13.0,95000,4,0.25,168,47500,46267,47508,47500,1233
8.0,95000,4,0.25,168,47500,46767,48002,47500,733
7.0,95000,5,0.025,210,47500,46648,95000,46648,0
12.0,95000,5,0.125,210,47500,46997,93569,47147,150
15.0,95000,8,0.1,336,47500,45915,94865,46441,526
4.0,95000,4,0.2,168,47500,46562,78002,47498,936
20.0,95000,2,0.05,84,47500,47058,95000,47058,0
14.0,95000,8,0.25,336,47500,46821,47501,47500,679
10.0,95000,4,0.175,168,47500,46480,70538,47500,1020
9.0,95000,4,0.125,168,47500,46219,94194,46417,198
11.0,95000,5,0.075,210,47500,47119,94999,47118,-1
1.0,95000,3,0.175,126,47672,47672,92179,47647,-25
20.0,95000,2,0.05,84,47500,47058,95000,47058,0
8.0,95000,5,0.025,210,47500,46778,95000,46778,0
3.0,95000,4,0.2,168,47500,45715,82216,47484,1769
7.0,95000,5,0.05,210,47500,46648,95000,46648,0
12.0,95000,5,0.15,210,47500,46997,84489,47500,503
13.0,95000,5,0.025,210,47500,46309,95000,46309,0
2.0,95000,4,0.175,168,47500,45288,91457,45398,110
15.0,95000,8,0.125,336,47500,45915,91875,47353,1438
5.0,95000,4,0.075,168,47500,45829,94998,45827,-2
6.0,95000,4,0.125,168,47500,46792,94594,46314,-478
4.0,95000,4,0.225,168,47500,46562,65726,47491,929
20.0,95000,2,0.075,84,47500,47058,95000,47058,0
14.0,95000,9,0.025,378,47500,46888,95000,46888,0
11.0,95000,5,0.1,210,47500,47119,94953,47037,-82
10.0,95000,4,0.2,168,47500,46480,54941,47500,1020
20.0,95000,2,0.075,84,47500,47058,95000,47058,0
8.0,95000,5,0.05,210,47500,46778,95000,46778,0
12.0,95000,5,0.175,210,47500,46997,64921,47500,503
7.0,95000,5,0.075,210,47500,46648,95000,46648,0
3.0,95000,4,0.225,168,47500,45715,71469,47494,1779
9.0,95000,4,0.15,168,47500,46219,88694,47500,1281
13.0,95000,5,0.05,210,47500,46309,95000,46309,0
15.0,95000,8,0.15,336,47500,45915,76882,47500,1585
1.0,95000,3,0.2,126,47672,47672,87951,47594,-78
4.0,95000,4,0.25,168,47500,46562,55274,47488,926
20.0,95000,2,0.1,84,47500,47058,94720,46706,-352
2.0,95000,4,0.2,168,47500,45288,85577,47202,1914
14.0,95000,9,0.05,378,47500,46888,95000,46888,0
11.0,95000,5,0.125,210,47500,47119,93806,44914,-2205
5.0,95000,4,0.1,168,47500,45829,94969,45499,-330
6.0,95000,4,0.15,168,47500,46792,92041,47222,430
12.0,95000,5,0.2,210,47500,46997,51318,47500,503
8.0,95000,5,0.075,210,47500,46778,95000,46778,0
20.0,95000,2,0.1,84,47500,47058,94720,46706,-352
7.0,95000,5,0.1,210,47500,46648,94980,46629,-19
10.0,95000,4,0.225,168,47500,46480,48672,47500,1020
3.0,95000,4,0.25,168,47500,45715,60346,47482,1767
15.0,95000,8,0.175,336,47500,45915,56407,47500,1585
4.0,95000,5,0.025,210,47500,46376,95000,46376,0
13.0,95000,5,0.075,210,47500,46309,94999,46308,-1
20.0,95000,2,0.125,84,47500,47058,88820,47500,442
9.0,95000,4,0.175,168,47500,46219,74178,47500,1281
11.0,95000,5,0.15,210,47500,47119,86230,47500,381
14.0,95000,9,0.075,378,47500,46888,94998,46886,-2
12.0,95000,5,0.225,210,47500,46997,47851,47500,503
1.0,95000,3,0.225,126,47672,47672,83103,47525,-147
5.0,95000,4,0.125,168,47500,45829,94662,45500,-329
2.0,95000,4,0.225,168,47500,45288,77707,47446,2158
8.0,95000,5,0.1,210,47500,46778,94968,46747,-31
20.0,95000,2,0.125,84,47500,47058,88820,47500,442
7.0,95000,5,0.125,210,47500,46648,94562,45362,-1286
15.0,95000,8,0.2,336,47500,45915,48500,47500,1585
10.0,95000,4,0.25,168,47500,46480,47588,47500,1020
3.0,95000,5,0.025,210,47500,45644,95000,45644,0
6.0,95000,4,0.175,168,47500,46792,83678,47489,697
20.0,95000,2,0.15,84,47500,47058,66800,47500,442
4.0,95000,5,0.05,210,47500,46376,95000,46376,0
11.0,95000,5,0.175,210,47500,47119,68296,47500,381
14.0,95000,9,0.1,378,47500,46888,94900,46739,-149
12.0,95000,5,0.25,210,47500,46997,47512,47500,503
8.0,95000,5,0.125,210,47500,46778,94379,45307,-1471
20.0,95000,2,0.15,84,47500,47058,66800,47500,442
13.0,95000,5,0.1,210,47500,46309,94922,46143,-166
7.0,95000,5,0.15,210,47500,46648,91371,47447,799
15.0,95000,8,0.225,336,47500,45915,47551,47500,1585
9.0,95000,4,0.2,168,47500,46219,57871,47500,1281
2.0,95000,4,0.25,168,47500,45288,68954,47462,2174
