Coefficient,Nodes,Trial,Epsilon,Seed,GroundTruth_MIS,Greedy_MIS,Size_S,Oracle_MIS,Improvement
3.0,90000,0,0.025,0,45000,42675,90000,42675,0
2.0,90000,0,0.025,0,45000,42672,90000,42672,0
4.0,90000,0,0.025,0,45000,44065,90000,44065,0
3.0,90000,0,0.05,0,45000,42675,90000,42675,0
4.0,90000,0,0.05,0,45000,44065,90000,44065,0
2.0,90000,0,0.05,0,45000,42672,90000,42672,0
3.0,90000,0,0.075,0,45000,42675,90000,42675,0
4.0,90000,0,0.075,0,45000,44065,90000,44065,0
3.0,90000,0,0.1,0,45000,42675,89975,42598,-77
4.0,90000,0,0.1,0,45000,44065,89977,44043,-22
5.0,90000,0,0.025,0,45000,44551,90000,44551,0
2.0,90000,0,0.075,0,45000,42672,89996,42668,-4
3.0,90000,0,0.125,0,45000,42675,89788,42840,165
4.0,90000,0,0.125,0,45000,44065,89757,43620,-445
5.0,90000,0,0.05,0,45000,44551,90000,44551,0
3.0,90000,0,0.15,0,45000,42675,88766,42840,165
4.0,90000,0,0.15,0,45000,44065,88204,43513,-552
2.0,90000,0,0.1,0,45000,42672,89959,42592,-80
5.0,90000,0,0.075,0,45000,44551,89999,44550,-1
3.0,90000,0,0.175,0,45000,42675,85014,44524,1849
4.0,90000,0,0.175,0,45000,44065,83708,44908,843
2.0,90000,0,0.125,0,45000,42672,89735,42108,-564
7.0,90000,0,0.025,0,45000,44278,90000,44278,0
3.0,90000,0,0.2,0,45000,42675,78002,44975,2300
5.0,90000,0,0.1,0,45000,44551,89981,44532,-19
4.0,90000,0,0.2,0,45000,44065,74007,44994,929
7.0,90000,0,0.05,0,45000,44278,90000,44278,0
3.0,90000,0,0.225,0,45000,42675,67919,44995,2320
4.0,90000,0,0.225,0,45000,44065,62136,44996,931
5.0,90000,0,0.125,0,45000,44551,89705,44103,-448
2.0,90000,0,0.15,0,45000,42672,88758,42661,-11
7.0,90000,0,0.075,0,45000,44278,90000,44278,0
3.0,90000,0,0.25,0,45000,42675,57244,44979,2304
4.0,90000,0,0.25,0,45000,44065,52386,44990,925
5.0,90000,0,0.15,0,45000,44551,87699,44289,-262
7.0,90000,0,0.1,0,45000,44278,89975,44254,-24
3.0,90000,1,0.025,42,45000,42882,90000,42882,0
4.0,90000,1,0.025,42,45000,43788,90000,43788,0
2.0,90000,0,0.175,0,45000,42672,86620,42674,2
6.0,90000,0,0.025,0,45000,44101,90000,44101,0
7.0,90000,0,0.125,0,45000,44278,89505,43276,-1002
9.0,90000,0,0.025,0,45000,44048,90000,44048,0
8.0,90000,0,0.025,0,45000,44234,90000,44234,0
5.0,90000,0,0.175,0,45000,44551,81462,44973,422
3.0,90000,1,0.05,42,45000,42882,90000,42882,0
4.0,90000,1,0.05,42,45000,43788,90000,43788,0
11.0,90000,0,0.025,0,45000,43954,90000,43954,0
10.0,90000,0,0.025,0,45000,44193,90000,44193,0
12.0,90000,0,0.025,0,45000,44036,90000,44036,0
13.0,90000,0,0.025,0,45000,44467,90000,44467,0
15.0,90000,0,0.025,0,45000,44053,90000,44053,0
14.0,90000,0,0.025,0,45000,44274,90000,44274,0
7.0,90000,0,0.15,0,45000,44278,86155,44878,600
6.0,90000,0,0.05,0,45000,44101,90000,44101,0
9.0,90000,0,0.05,0,45000,44048,90000,44048,0
8.0,90000,0,0.05,0,45000,44234,90000,44234,0
3.0,90000,1,0.075,42,45000,42882,89998,42862,-20
4.0,90000,1,0.075,42,45000,43788,89999,43787,-1
2.0,90000,0,0.2,0,45000,42672,81216,44722,2050
5.0,90000,0,0.2,0,45000,44551,69624,45000,449
11.0,90000,0,0.05,0,45000,43954,90000,43954,0
12.0,90000,0,0.05,0,45000,44036,90000,44036,0
10.0,90000,0,0.05,0,45000,44193,90000,44193,0
13.0,90000,0,0.05,0,45000,44467,90000,44467,0
9.0,90000,0,0.075,0,45000,44048,89999,44047,-1
15.0,90000,0,0.05,0,45000,44053,90000,44053,0
7.0,90000,0,0.175,0,45000,44278,76081,45000,722
8.0,90000,0,0.075,0,45000,44234,90000,44234,0
14.0,90000,0,0.05,0,45000,44274,90000,44274,0
3.0,90000,1,0.1,42,45000,42882,89975,42793,-89
4.0,90000,1,0.1,42,45000,43788,89981,43742,-46
6.0,90000,0,0.075,0,45000,44101,90000,44101,0
5.0,90000,0,0.225,0,45000,44551,57194,45000,449
9.0,90000,0,0.1,0,45000,44048,89964,43872,-176
8.0,90000,0,0.1,0,45000,44234,89968,44203,-31
7.0,90000,0,0.2,0,45000,44278,60958,45000,722
11.0,90000,0,0.075,0,45000,43954,90000,43954,0
2.0,90000,0,0.225,0,45000,42672,73737,44948,2276
12.0,90000,0,0.075,0,45000,44036,90000,44036,0
10.0,90000,0,0.075,0,45000,44193,90000,44193,0
13.0,90000,0,0.075,0,45000,44467,90000,44467,0
3.0,90000,1,0.125,42,45000,42882,89749,42028,-854
15.0,90000,0,0.075,0,45000,44053,90000,44053,0
4.0,90000,1,0.125,42,45000,43788,89723,43330,-458
14.0,90000,0,0.075,0,45000,44274,89999,44274,0
6.0,90000,0,0.1,0,45000,44101,89977,44078,-23
9.0,90000,0,0.125,0,45000,44048,89204,44058,10
7.0,90000,0,0.225,0,45000,44278,50154,45000,722
8.0,90000,0,0.125,0,45000,44234,89357,44153,-81
5.0,90000,0,0.25,0,45000,44551,49481,44996,445
11.0,90000,0,0.1,0,45000,43954,89936,43954,0
3.0,90000,1,0.15,42,45000,42882,88755,42819,-63
4.0,90000,1,0.15,42,45000,43788,88307,43801,13
12.0,90000,0,0.1,0,45000,44036,89942,44036,0
10.0,90000,0,0.1,0,45000,44193,89953,44147,-46
13.0,90000,0,0.1,0,45000,44467,89916,44467,0
9.0,90000,0,0.15,0,45000,44048,83855,45000,952
7.0,90000,0,0.25,0,45000,44278,46066,44999,721
15.0,90000,0,0.1,0,45000,44053,89872,44215,162
8.0,90000,0,0.15,0,45000,44234,85040,44979,745
2.0,90000,0,0.25,0,45000,42672,65624,44960,2288
6.0,90000,0,0.125,0,45000,44101,89565,43329,-772
14.0,90000,0,0.1,0,45000,44274,89899,44274,0
5.0,90000,1,0.025,42,45000,44371,90000,44371,0
4.0,90000,1,0.175,42,45000,43788,83851,44938,1150
3.0,90000,1,0.175,42,45000,42882,85104,44615,1733
11.0,90000,0,0.125,0,45000,43954,88739,44689,735
9.0,90000,0,0.175,0,45000,44048,69936,45000,952
7.0,90000,1,0.025,42,45000,43881,90000,43881,0
12.0,90000,0,0.125,0,45000,44036,88448,44728,692
8.0,90000,0,0.175,0,45000,44234,72994,45000,766
10.0,90000,0,0.125,0,45000,44193,89029,44470,277
13.0,90000,0,0.125,0,45000,44467,88009,45000,533
15.0,90000,0,0.125,0,45000,44053,87154,45000,947
6.0,90000,0,0.15,0,45000,44101,87011,44699,598
4.0,90000,1,0.2,42,45000,43788,74308,44998,1210
3.0,90000,1,0.2,42,45000,42882,78206,44973,2091
14.0,90000,0,0.125,0,45000,44274,87592,45000,726
9.0,90000,0,0.2,0,45000,44048,54272,45000,952
2.0,90000,1,0.025,42,45002,42612,90000,42612,0
5.0,90000,1,0.05,42,45000,44371,90000,44371,0
7.0,90000,1,0.05,42,45000,43881,90000,43881,0
8.0,90000,0,0.2,0,45000,44234,57427,45000,766
11.0,90000,0,0.15,0,45000,43954,80695,45000,1046
12.0,90000,0,0.15,0,45000,44036,78891,45000,964
10.0,90000,0,0.15,0,45000,44193,82282,45000,807
13.0,90000,0,0.15,0,45000,44467,76928,45000,533
9.0,90000,0,0.225,0,45000,44048,46927,45000,952
4.0,90000,1,0.225,42,45000,43788,62505,44998,1210
8.0,90000,0,0.225,0,45000,44234,48186,45000,766
3.0,90000,1,0.225,42,45000,42882,68202,44994,2112
15.0,90000,0,0.15,0,45000,44053,72834,45000,947
7.0,90000,1,0.075,42,45000,43881,90000,43881,0
6.0,90000,0,0.175,0,45000,44101,78475,45000,899
14.0,90000,0,0.15,0,45000,44274,74853,45000,726
5.0,90000,1,0.075,42,45000,44371,89999,44370,-1
11.0,90000,0,0.175,0,45000,43954,63708,45000,1046
9.0,90000,0,0.25,0,45000,44048,45222,45000,952
12.0,90000,0,0.175,0,45000,44036,60338,45000,964
8.0,90000,0,0.25,0,45000,44234,45505,44999,765
10.0,90000,0,0.175,0,45000,44193,66200,45000,807
4.0,90000,1,0.25,42,45000,43788,52708,44995,1207
2.0,90000,1,0.05,42,45002,42612,90000,42612,0
3.0,90000,1,0.25,42,45000,42882,57555,44981,2099
7.0,90000,1,0.1,42,45000,43881,89974,43856,-25
13.0,90000,0,0.175,0,45000,44467,57856,45000,533
15.0,90000,0,0.175,0,45000,44053,53573,45000,947
6.0,90000,0,0.2,0,45000,44101,64924,45000,899
9.0,90000,1,0.025,42,45000,44576,90000,44576,0
5.0,90000,1,0.1,42,45000,44371,89974,44345,-26
14.0,90000,0,0.175,0,45000,44274,55719,45000,726
11.0,90000,0,0.2,0,45000,43954,49853,45000,1046
8.0,90000,1,0.025,42,45000,43452,90000,43452,0
4.0,90000,2,0.025,84,45000,43659,90000,43659,0
7.0,90000,1,0.125,42,45000,43881,89463,43671,-210
12.0,90000,0,0.2,0,45000,44036,48393,45000,964
3.0,90000,2,0.025,84,45000,42966,90000,42966,0
10.0,90000,0,0.2,0,45000,44193,51909,45000,807
13.0,90000,0,0.2,0,45000,44467,47298,45000,533
9.0,90000,1,0.05,42,45000,44576,90000,44576,0
2.0,90000,1,0.075,42,45002,42612,89998,42612,0
8.0,90000,1,0.05,42,45000,43452,90000,43452,0
15.0,90000,0,0.2,0,45000,44053,45977,45000,947
6.0,90000,0,0.225,0,45000,44101,53145,45000,899
4.0,90000,2,0.05,84,45000,43659,90000,43659,0
11.0,90000,0,0.225,0,45000,43954,45606,45000,1046
7.0,90000,1,0.15,42,45000,43881,86210,44809,928
5.0,90000,1,0.125,42,45000,44371,89680,43841,-530
14.0,90000,0,0.2,0,45000,44274,46539,45000,726
3.0,90000,2,0.05,84,45000,42966,90000,42966,0
12.0,90000,0,0.225,0,45000,44036,45347,45000,964
10.0,90000,0,0.225,0,45000,44193,46092,45000,807
9.0,90000,1,0.075,42,45000,44576,90000,44576,0
13.0,90000,0,0.225,0,45000,44467,45178,45000,533
8.0,90000,1,0.075,42,45000,43452,90000,43452,0
4.0,90000,2,0.075,84,45000,43659,89998,43657,-2
15.0,90000,0,0.225,0,45000,44053,45045,45000,947
7.0,90000,1,0.175,42,45000,43881,76522,45000,1119
6.0,90000,0,0.25,0,45000,44101,47116,44999,898
3.0,90000,2,0.075,84,45000,42966,89998,42965,-1
11.0,90000,0,0.25,0,45000,43954,45034,45000,1046
14.0,90000,0,0.225,0,45000,44274,45091,45000,726
5.0,90000,1,0.15,42,45000,44371,87640,44408,37
9.0,90000,1,0.1,42,45000,44576,89950,44526,-50
12.0,90000,0,0.25,0,45000,44036,45017,45000,964
10.0,90000,0,0.25,0,45000,44193,45091,45000,807
2.0,90000,1,0.1,42,45002,42612,89964,42612,0
8.0,90000,1,0.1,42,45000,43452,89964,43393,-59
13.0,90000,0,0.25,0,45000,44467,45007,45000,533
7.0,90000,1,0.2,42,45000,43881,61582,44999,1118
4.0,90000,2,0.1,84,45000,43659,89977,43592,-67
3.0,90000,2,0.1,84,45000,42966,89973,42916,-50
15.0,90000,0,0.25,0,45000,44053,45001,45000,947
9.0,90000,1,0.125,42,45000,44576,89154,43310,-1266
6.0,90000,1,0.025,42,45000,44076,90000,44076,0
11.0,90000,1,0.025,42,45000,44407,90000,44407,0
8.0,90000,1,0.125,42,45000,43452,89317,43782,330
14.0,90000,0,0.25,0,45000,44274,45000,45000,726
5.0,90000,1,0.175,42,45000,44371,81721,44983,612
12.0,90000,1,0.025,42,45000,44500,90000,44500,0
10.0,90000,1,0.025,42,45000,44790,90000,44790,0
7.0,90000,1,0.225,42,45000,43881,50537,44999,1118
4.0,90000,2,0.125,84,45000,43659,89739,43075,-584
13.0,90000,1,0.025,42,45000,44398,90000,44398,0
3.0,90000,2,0.125,84,45000,42966,89742,42190,-776
9.0,90000,1,0.15,42,45000,44576,84000,44960,384
2.0,90000,1,0.125,42,45002,42612,89728,42602,-10
8.0,90000,1,0.15,42,45000,43452,85289,44905,1453
15.0,90000,1,0.025,42,45000,44479,90000,44479,0
6.0,90000,1,0.05,42,45000,44076,90000,44076,0
11.0,90000,1,0.05,42,45000,44407,90000,44407,0
7.0,90000,1,0.25,42,45000,43881,46166,44996,1115
4.0,90000,2,0.15,84,45000,43659,88297,43809,150
5.0,90000,1,0.2,42,45000,44371,70037,45000,629
12.0,90000,1,0.05,42,45000,44500,90000,44500,0
14.0,90000,1,0.025,42,45000,44572,90000,44572,0
10.0,90000,1,0.05,42,45000,44790,90000,44790,0
9.0,90000,1,0.175,42,45000,44576,70448,45000,424
3.0,90000,2,0.15,84,45000,42966,88732,41949,-1017
8.0,90000,1,0.175,42,45000,43452,73472,45000,1548
13.0,90000,1,0.05,42,45000,44398,90000,44398,0
7.0,90000,2,0.025,84,45000,43689,90000,43689,0
4.0,90000,2,0.175,84,45000,43659,83780,44883,1224
11.0,90000,1,0.075,42,45000,44407,90000,44407,0
6.0,90000,1,0.075,42,45000,44076,90000,44076,0
9.0,90000,1,0.2,42,45000,44576,54725,45000,424
15.0,90000,1,0.05,42,45000,44479,90000,44479,0
8.0,90000,1,0.2,42,45000,43452,57851,45000,1548
2.0,90000,1,0.15,42,45002,42612,88700,44700,2088
5.0,90000,1,0.225,42,45000,44371,57597,44998,627
3.0,90000,2,0.175,84,45000,42966,85176,44555,1589
12.0,90000,1,0.075,42,45000,44500,90000,44500,0
10.0,90000,1,0.075,42,45000,44790,90000,44790,0
14.0,90000,1,0.05,42,45000,44572,90000,44572,0
7.0,90000,2,0.05,84,45000,43689,90000,43689,0
13.0,90000,1,0.075,42,45000,44398,90000,44398,0
9.0,90000,1,0.225,42,45000,44576,47108,44999,423
4.0,90000,2,0.2,84,45000,43659,74429,44996,1337
8.0,90000,1,0.225,42,45000,43452,48433,44999,1547
11.0,90000,1,0.1,42,45000,44407,89945,44316,-91
3.0,90000,2,0.2,84,45000,42966,78353,44974,2008
6.0,90000,1,0.1,42,45000,44076,89975,44051,-25
5.0,90000,1,0.25,42,45000,44371,49729,44999,628
15.0,90000,1,0.075,42,45000,44479,89999,44478,-1
7.0,90000,2,0.075,84,45000,43689,89998,43688,-1
12.0,90000,1,0.1,42,45000,44500,89934,44434,-66
10.0,90000,1,0.1,42,45000,44790,89959,44750,-40
9.0,90000,1,0.25,42,45000,44576,45232,44997,421
8.0,90000,1,0.25,42,45000,43452,45531,44998,1546
14.0,90000,1,0.075,42,45000,44572,89999,44571,-1
13.0,90000,1,0.1,42,45000,44398,89914,44269,-129
2.0,90000,1,0.175,42,45002,42612,86562,44703,2091
4.0,90000,2,0.225,84,45000,43659,62366,44996,1337
3.0,90000,2,0.225,84,45000,42966,68063,44988,2022
7.0,90000,2,0.1,84,45000,43689,89978,43589,-100
11.0,90000,1,0.125,42,45000,44407,88708,44300,-107
9.0,90000,2,0.025,84,45000,43546,90000,43546,0
6.0,90000,1,0.125,42,45000,44076,89587,43466,-610
5.0,90000,2,0.025,84,45000,44269,90000,44269,0
8.0,90000,2,0.025,84,45000,44091,90000,44091,0
10.0,90000,1,0.125,42,45000,44790,88985,43114,-1676
4.0,90000,2,0.25,84,45000,43659,52591,44984,1325
12.0,90000,1,0.125,42,45000,44500,88441,44812,312
15.0,90000,1,0.1,42,45000,44479,89882,44361,-118
13.0,90000,1,0.125,42,45000,44398,88036,44791,393
14.0,90000,1,0.1,42,45000,44572,89891,44463,-109
3.0,90000,2,0.25,84,45000,42966,57583,44973,2007
7.0,90000,2,0.125,84,45000,43689,89530,44239,550
9.0,90000,2,0.05,84,45000,43546,90000,43546,0
8.0,90000,2,0.05,84,45000,44091,90000,44091,0
2.0,90000,1,0.2,42,45002,42612,81000,44956,2344
11.0,90000,1,0.15,42,45000,44407,81040,45000,593
4.0,90000,3,0.025,126,45000,43334,90000,43334,0
6.0,90000,1,0.15,42,45000,44076,87156,44649,573
5.0,90000,2,0.05,84,45000,44269,90000,44269,0
10.0,90000,1,0.15,42,45000,44790,82487,45000,210
12.0,90000,1,0.15,42,45000,44500,79346,45000,500
3.0,90000,3,0.025,126,45000,41773,90000,41773,0
15.0,90000,1,0.125,42,45000,44479,87158,44903,424
9.0,90000,2,0.075,84,45000,43546,89999,43545,-1
7.0,90000,2,0.15,84,45000,43689,86395,44809,1120
13.0,90000,1,0.15,42,45000,44398,77465,45000,602
8.0,90000,2,0.075,84,45000,44091,89998,44089,-2
14.0,90000,1,0.125,42,45000,44572,87640,44867,295
4.0,90000,3,0.05,126,45000,43334,90000,43334,0
11.0,90000,1,0.175,42,45000,44407,64289,45000,593
9.0,90000,2,0.1,84,45000,43546,89964,42727,-819
6.0,90000,1,0.175,42,45000,44076,79200,45000,924
3.0,90000,3,0.05,126,45000,41773,90000,41773,0
7.0,90000,2,0.175,84,45000,43689,76398,45000,1311
5.0,90000,2,0.075,84,45000,44269,89998,44267,-2
10.0,90000,1,0.175,42,45000,44790,66996,45000,210
12.0,90000,1,0.175,42,45000,44500,61154,45000,500
2.0,90000,1,0.225,42,45002,42612,73730,44983,2371
8.0,90000,2,0.1,84,45000,44091,89976,44043,-48
15.0,90000,1,0.15,42,45000,44479,73403,45000,521
13.0,90000,1,0.175,42,45000,44398,58504,45000,602
4.0,90000,3,0.075,126,45000,43334,89999,43324,-10
14.0,90000,1,0.15,42,45000,44572,75349,45000,428
9.0,90000,2,0.125,84,45000,43546,89274,43979,433
7.0,90000,2,0.2,84,45000,43689,61584,45000,1311
11.0,90000,1,0.2,42,45000,44407,50110,45000,593
3.0,90000,3,0.075,126,45000,41773,89996,41769,-4
8.0,90000,2,0.125,84,45000,44091,89441,43623,-468
6.0,90000,1,0.2,42,45000,44076,65884,45000,924
5.0,90000,2,0.1,84,45000,44269,89983,44253,-16
10.0,90000,1,0.2,42,45000,44790,52227,45000,210
12.0,90000,1,0.2,42,45000,44500,48589,45000,500
4.0,90000,3,0.1,126,45000,43334,89983,43310,-24
13.0,90000,1,0.2,42,45000,44398,47426,45000,602
9.0,90000,2,0.15,84,45000,43546,84167,44954,1408
15.0,90000,1,0.175,42,45000,44479,54210,45000,521
7.0,90000,2,0.225,84,45000,43689,50523,45000,1311
2.0,90000,1,0.25,42,45002,42612,65414,44962,2350
3.0,90000,3,0.1,126,45000,41773,89975,41732,-41
8.0,90000,2,0.15,84,45000,44091,85280,44958,867
11.0,90000,1,0.225,42,45000,44407,45687,45000,593
14.0,90000,1,0.175,42,45000,44572,56351,45000,428
6.0,90000,1,0.225,42,45000,44076,53556,44999,923
5.0,90000,2,0.125,84,45000,44269,89708,43903,-366
4.0,90000,3,0.125,126,45000,43334,89742,42900,-434
12.0,90000,1,0.225,42,45000,44500,45350,45000,500
10.0,90000,1,0.225,42,45000,44790,46192,45000,210
9.0,90000,2,0.175,84,45000,43546,70282,45000,1454
7.0,90000,2,0.25,84,45000,43689,46154,44998,1309
13.0,90000,1,0.225,42,45000,44398,45184,45000,602
8.0,90000,2,0.175,84,45000,44091,73327,45000,909
3.0,90000,3,0.125,126,45000,41773,89761,42790,1017
15.0,90000,1,0.2,42,45000,44479,46111,45000,521
11.0,90000,1,0.25,42,45000,44407,45050,45000,593
14.0,90000,1,0.2,42,45000,44572,46646,45000,428
9.0,90000,2,0.2,84,45000,43546,54744,45000,1454
4.0,90000,3,0.15,126,45000,43334,88268,43690,356
7.0,90000,3,0.025,126,45000,43964,90000,43964,0
2.0,90000,2,0.025,84,45002,42685,90000,42685,0
6.0,90000,1,0.25,42,45000,44076,47549,44997,921
12.0,90000,1,0.25,42,45000,44500,45024,45000,500
10.0,90000,1,0.25,42,45000,44790,45112,45000,210
8.0,90000,2,0.2,84,45000,44091,57972,45000,909
3.0,90000,3,0.15,126,45000,41773,88736,42790,1017
13.0,90000,1,0.25,42,45000,44398,45008,44999,601
9.0,90000,2,0.225,84,45000,43546,47086,45000,1454
15.0,90000,1,0.225,42,45000,44479,45055,45000,521
7.0,90000,3,0.05,126,45000,43964,90000,43964,0
11.0,90000,2,0.025,84,45000,44552,90000,44552,0
4.0,90000,3,0.175,126,45000,43334,83879,44885,1551
14.0,90000,1,0.225,42,45000,44572,45103,45000,428
8.0,90000,2,0.225,84,45000,44091,48417,45000,909
10.0,90000,2,0.025,84,45000,44314,90000,44314,0
3.0,90000,3,0.175,126,45000,41773,85084,44552,2779
12.0,90000,2,0.025,84,45000,44576,90000,44576,0
6.0,90000,2,0.025,84,45000,44019,90000,44019,0
9.0,90000,2,0.25,84,45000,43546,45207,44997,1451
13.0,90000,2,0.025,84,45000,44610,90000,44610,0
2.0,90000,2,0.05,84,45002,42685,89999,42672,-13
7.0,90000,3,0.075,126,45000,43964,90000,43964,0
8.0,90000,2,0.25,84,45000,44091,45514,44998,907
4.0,90000,3,0.2,126,45000,43334,74413,45000,1666
15.0,90000,1,0.25,42,45000,44479,45000,44999,520
11.0,90000,2,0.05,84,45000,44552,90000,44552,0
14.0,90000,1,0.25,42,45000,44572,45002,44999,427
9.0,90000,3,0.025,126,45000,44538,90000,44538,0
3.0,90000,3,0.2,126,45000,41773,78168,44978,3205
10.0,90000,2,0.05,84,45000,44314,90000,44314,0
12.0,90000,2,0.05,84,45000,44576,90000,44576,0
6.0,90000,2,0.05,84,45000,44019,90000,44019,0
7.0,90000,3,0.1,126,45000,43964,89979,43926,-38
8.0,90000,3,0.025,126,45000,43861,90000,43861,0
4.0,90000,3,0.225,126,45000,43334,62472,44996,1662
13.0,90000,2,0.05,84,45000,44610,90000,44610,0
5.0,90000,2,0.15,84,45000,44269,87803,44349,80
9.0,90000,3,0.05,126,45000,44538,90000,44538,0
15.0,90000,2,0.025,84,45000,44791,90000,44791,0
3.0,90000,3,0.225,126,45000,41773,68235,44993,3220
2.0,90000,2,0.075,84,45002,42685,89997,42671,-14
11.0,90000,2,0.075,84,45000,44552,89999,44551,-1
7.0,90000,3,0.125,126,45000,43964,89483,42788,-1176
8.0,90000,3,0.05,126,45000,43861,90000,43861,0
14.0,90000,2,0.025,84,45000,44611,90000,44611,0
4.0,90000,3,0.25,126,45000,43334,52690,44989,1655
10.0,90000,2,0.075,84,45000,44314,89998,44312,-2
12.0,90000,2,0.075,84,45000,44576,89998,44574,-2
6.0,90000,2,0.075,84,45000,44019,89999,44018,-1
9.0,90000,3,0.075,126,45000,44538,90000,44538,0
13.0,90000,2,0.075,84,45000,44610,89998,44608,-2
3.0,90000,3,0.25,126,45000,41773,57582,44974,3201
8.0,90000,3,0.075,126,45000,43861,90000,43861,0
7.0,90000,3,0.15,126,45000,43964,86373,44638,674
11.0,90000,2,0.1,84,45000,44552,89952,44505,-47
15.0,90000,2,0.05,84,45000,44791,90000,44791,0
4.0,90000,4,0.025,168,45000,43978,90000,43978,0
10.0,90000,2,0.1,84,45000,44314,89961,44179,-135
14.0,90000,2,0.05,84,45000,44611,90000,44611,0
2.0,90000,2,0.1,84,45002,42685,89967,42606,-79
9.0,90000,3,0.1,126,45000,44538,89961,44499,-39
12.0,90000,2,0.1,84,45000,44576,89942,44359,-217
3.0,90000,4,0.025,168,45000,42607,90000,42607,0
6.0,90000,2,0.1,84,45000,44019,89969,43925,-94
8.0,90000,3,0.1,126,45000,43861,89968,43861,0
13.0,90000,2,0.1,84,45000,44610,89928,44500,-110
7.0,90000,3,0.175,126,45000,43964,76682,45000,1036
4.0,90000,4,0.05,168,45000,43978,90000,43978,0
11.0,90000,2,0.125,84,45000,44552,88916,44265,-287
15.0,90000,2,0.075,84,45000,44791,89998,44789,-2
9.0,90000,3,0.125,126,45000,44538,89194,43286,-1252
3.0,90000,4,0.05,168,45000,42607,90000,42607,0
10.0,90000,2,0.125,84,45000,44314,89134,43718,-596
8.0,90000,3,0.125,126,45000,43861,89343,43861,0
7.0,90000,3,0.2,126,45000,43964,61504,45000,1036
14.0,90000,2,0.075,84,45000,44611,89998,44609,-2
12.0,90000,2,0.125,84,45000,44576,88674,44505,-71
6.0,90000,2,0.125,84,45000,44019,89616,43231,-788
4.0,90000,4,0.075,168,45000,43978,89997,43948,-30
2.0,90000,2,0.125,84,45002,42685,89756,41938,-747
13.0,90000,2,0.125,84,45000,44610,88311,44710,100
9.0,90000,3,0.15,126,45000,44538,84127,44977,439
11.0,90000,2,0.15,84,45000,44552,81312,45000,448
8.0,90000,3,0.15,126,45000,43861,85300,44835,974
3.0,90000,4,0.075,168,45000,42607,89998,42606,-1
7.0,90000,3,0.225,126,45000,43964,50530,45000,1036
15.0,90000,2,0.1,84,45000,44791,89910,44702,-89
10.0,90000,2,0.15,84,45000,44314,82839,45000,686
4.0,90000,4,0.1,168,45000,43978,89978,43931,-47
12.0,90000,2,0.15,84,45000,44576,79613,45000,424
14.0,90000,2,0.1,84,45000,44611,89919,44044,-567
6.0,90000,2,0.15,84,45000,44019,87210,44638,619
13.0,90000,2,0.15,84,45000,44610,77803,45000,390
8.0,90000,3,0.175,126,45000,43861,73684,45000,1139
9.0,90000,3,0.175,126,45000,44538,70439,45000,462
3.0,90000,4,0.1,168,45000,42607,89979,42499,-108
7.0,90000,3,0.25,126,45000,43964,46188,44998,1034
5.0,90000,2,0.175,84,45000,44269,81652,44947,678
11.0,90000,2,0.175,84,45000,44552,64053,45000,448
2.0,90000,2,0.15,84,45002,42685,88770,42525,-160
4.0,90000,4,0.125,168,45000,43978,89776,43427,-551
10.0,90000,2,0.175,84,45000,44314,66567,45000,686
15.0,90000,2,0.125,84,45000,44791,87601,44905,114
8.0,90000,3,0.2,126,45000,43861,57887,45000,1139
12.0,90000,2,0.175,84,45000,44576,60902,45000,424
9.0,90000,3,0.2,126,45000,44538,54764,45000,462
6.0,90000,2,0.175,84,45000,44019,78726,45000,981
7.0,90000,4,0.025,168,45000,44136,90000,44136,0
14.0,90000,2,0.125,84,45000,44611,87923,44636,25
3.0,90000,4,0.125,168,45000,42607,89781,43112,505
13.0,90000,2,0.175,84,45000,44610,58418,45000,390
11.0,90000,2,0.2,84,45000,44552,50207,45000,448
4.0,90000,4,0.15,168,45000,43978,88396,43876,-102
8.0,90000,3,0.225,126,45000,43861,48427,44999,1138
10.0,90000,2,0.2,84,45000,44314,52257,45000,686
9.0,90000,3,0.225,126,45000,44538,47108,45000,462
7.0,90000,4,0.05,168,45000,44136,90000,44136,0
2.0,90000,2,0.175,84,45002,42685,86624,42528,-157
12.0,90000,2,0.2,84,45000,44576,48690,45000,424
3.0,90000,4,0.15,168,45000,42607,88809,43129,522
15.0,90000,2,0.15,84,45000,44791,73931,45000,209
6.0,90000,2,0.2,84,45000,44019,65390,45000,981
5.0,90000,2,0.2,84,45000,44269,69997,45000,731
13.0,90000,2,0.2,84,45000,44610,47533,45000,390
14.0,90000,2,0.15,84,45000,44611,75915,45000,389
8.0,90000,3,0.25,126,45000,43861,45536,44999,1138
4.0,90000,4,0.175,168,45000,43978,84116,44704,726
11.0,90000,2,0.225,84,45000,44552,45665,45000,448
9.0,90000,3,0.25,126,45000,44538,45224,45000,462
7.0,90000,4,0.075,168,45000,44136,89999,44135,-1
10.0,90000,2,0.225,84,45000,44314,46189,45000,686
3.0,90000,4,0.175,168,45000,42607,85301,44642,2035
12.0,90000,2,0.225,84,45000,44576,45369,45000,424
8.0,90000,4,0.025,168,45000,43685,90000,43685,0
15.0,90000,2,0.175,84,45000,44791,54037,45000,209
6.0,90000,2,0.225,84,45000,44019,53465,44999,980
4.0,90000,4,0.2,168,45000,43978,74532,44998,1020
13.0,90000,2,0.225,84,45000,44610,45187,45000,390
9.0,90000,4,0.025,168,45000,43357,90000,43357,0
2.0,90000,2,0.2,84,45002,42685,81318,44673,1988
11.0,90000,2,0.25,84,45000,44552,45041,44999,447
14.0,90000,2,0.175,84,45000,44611,56057,45000,389
7.0,90000,4,0.1,168,45000,44136,89972,44109,-27
3.0,90000,4,0.2,168,45000,42607,78406,44983,2376
10.0,90000,2,0.25,84,45000,44314,45088,44999,685
8.0,90000,4,0.05,168,45000,43685,90000,43685,0
12.0,90000,2,0.25,84,45000,44576,45016,45000,424
4.0,90000,4,0.225,168,45000,43978,62632,44995,1017
5.0,90000,2,0.225,84,45000,44269,57318,44995,726
9.0,90000,4,0.05,168,45000,43357,90000,43357,0
6.0,90000,2,0.25,84,45000,44019,47143,44997,978
13.0,90000,2,0.25,84,45000,44610,45006,45000,390
15.0,90000,2,0.2,84,45000,44791,46137,45000,209
7.0,90000,4,0.125,168,45000,44136,89549,44204,68
11.0,90000,3,0.025,126,45000,43986,90000,43986,0
14.0,90000,2,0.2,84,45000,44611,46706,45000,389
3.0,90000,4,0.225,168,45000,42607,68226,44991,2384
8.0,90000,4,0.075,168,45000,43685,90000,43685,0
10.0,90000,3,0.025,126,45000,43880,90000,43880,0
2.0,90000,2,0.225,84,45002,42685,73852,44942,2257
4.0,90000,4,0.25,168,45000,43978,52629,44992,1014
9.0,90000,4,0.075,168,45000,43357,90000,43357,0
12.0,90000,3,0.025,126,45000,43862,90000,43862,0
7.0,90000,4,0.15,168,45000,44136,86481,44928,792
13.0,90000,3,0.025,126,45000,43546,90000,43546,0
6.0,90000,3,0.025,126,45000,43895,90000,43895,0
15.0,90000,2,0.225,84,45000,44791,45038,45000,209
8.0,90000,4,0.1,168,45000,43685,89971,44107,422
3.0,90000,4,0.25,168,45000,42607,57491,44982,2375
11.0,90000,3,0.05,126,45000,43986,90000,43986,0
14.0,90000,2,0.225,84,45000,44611,45100,45000,389
4.0,90000,5,0.025,210,45000,43476,90000,43476,0
5.0,90000,2,0.25,84,45000,44269,49747,44992,723
9.0,90000,4,0.1,168,45000,43357,89967,43297,-60
10.0,90000,3,0.05,126,45000,43880,90000,43880,0
7.0,90000,4,0.175,168,45000,44136,77169,45000,864
12.0,90000,3,0.05,126,45000,43862,90000,43862,0
8.0,90000,4,0.125,168,45000,43685,89444,44107,422
2.0,90000,2,0.25,84,45002,42685,65741,44959,2274
3.0,90000,5,0.025,210,45000,44564,90000,44564,0
13.0,90000,3,0.05,126,45000,43546,90000,43546,0
15.0,90000,2,0.25,84,45000,44791,45001,45000,209
6.0,90000,3,0.05,126,45000,43895,90000,43895,0
4.0,90000,5,0.05,210,45000,43476,90000,43476,0
11.0,90000,3,0.075,126,45000,43986,89999,43986,0
9.0,90000,4,0.125,168,45000,43357,89286,44322,965
14.0,90000,2,0.25,84,45000,44611,45003,45000,389
7.0,90000,4,0.2,168,45000,44136,61832,44999,863
5.0,90000,3,0.025,126,45000,44175,90000,44175,0
10.0,90000,3,0.075,126,45000,43880,90000,43880,0
8.0,90000,4,0.15,168,45000,43685,85399,45000,1315
12.0,90000,3,0.075,126,45000,43862,89998,43860,-2
3.0,90000,5,0.05,210,45000,44564,90000,44564,0
4.0,90000,5,0.075,210,45000,43476,89998,43465,-11
13.0,90000,3,0.075,126,45000,43546,89998,43546,0
7.0,90000,4,0.225,168,45000,44136,50600,45000,864
9.0,90000,4,0.15,168,45000,43357,84376,45000,1643
6.0,90000,3,0.075,126,45000,43895,89999,43894,-1
15.0,90000,3,0.025,126,45000,43645,90000,43645,0
11.0,90000,3,0.1,126,45000,43986,89946,43986,0
2.0,90000,3,0.025,126,45000,42492,90000,42492,0
8.0,90000,4,0.175,168,45000,43685,74298,45000,1315
14.0,90000,3,0.025,126,45000,43846,90000,43846,0
5.0,90000,3,0.05,126,45000,44175,90000,44175,0
10.0,90000,3,0.1,126,45000,43880,89967,43848,-32
3.0,90000,5,0.075,210,45000,44564,90000,44564,0
7.0,90000,4,0.25,168,45000,44136,46104,44999,863
4.0,90000,5,0.1,210,45000,43476,89981,43449,-27
12.0,90000,3,0.1,126,45000,43862,89932,43755,-107
9.0,90000,4,0.175,168,45000,43357,71438,45000,1643
8.0,90000,4,0.2,168,45000,43685,58263,45000,1315
13.0,90000,3,0.1,126,45000,43546,89918,43546,0
6.0,90000,3,0.1,126,45000,43895,89982,43862,-33
11.0,90000,3,0.125,126,45000,43986,88724,44561,575
15.0,90000,3,0.05,126,45000,43645,90000,43645,0
5.0,90000,3,0.075,126,45000,44175,89998,44173,-2
7.0,90000,5,0.025,210,45000,44097,90000,44097,0
10.0,90000,3,0.125,126,45000,43880,88990,44522,642
14.0,90000,3,0.05,126,45000,43846,90000,43846,0
3.0,90000,5,0.1,210,45000,44564,89977,44536,-28
4.0,90000,5,0.125,210,45000,43476,89748,42860,-616
2.0,90000,3,0.05,126,45000,42492,90000,42492,0
8.0,90000,4,0.225,168,45000,43685,48461,45000,1315
9.0,90000,4,0.2,168,45000,43357,55069,45000,1643
12.0,90000,3,0.125,126,45000,43862,88387,44430,568
13.0,90000,3,0.125,126,45000,43546,88133,44752,1206
6.0,90000,3,0.125,126,45000,43895,89560,43117,-778
11.0,90000,3,0.15,126,45000,43986,81162,45000,1014
7.0,90000,5,0.05,210,45000,44097,90000,44097,0
15.0,90000,3,0.075,126,45000,43645,89998,43643,-2
4.0,90000,5,0.15,210,45000,43476,88378,43702,226
8.0,90000,4,0.25,168,45000,43685,45484,44999,1314
3.0,90000,5,0.125,210,45000,44564,89773,44279,-285
9.0,90000,4,0.225,168,45000,43357,47170,45000,1643
5.0,90000,3,0.1,126,45000,44175,89979,44155,-20
10.0,90000,3,0.15,126,45000,43880,82724,45000,1120
14.0,90000,3,0.075,126,45000,43846,89998,43697,-149
12.0,90000,3,0.15,126,45000,43862,79468,45000,1138
2.0,90000,3,0.075,126,45000,42492,89997,42490,-2
7.0,90000,5,0.075,210,45000,44097,90000,44097,0
8.0,90000,5,0.025,210,45000,43797,90000,43797,0
13.0,90000,3,0.15,126,45000,43546,77533,45000,1454
4.0,90000,5,0.175,210,45000,43476,83883,44884,1408
9.0,90000,4,0.25,168,45000,43357,45219,45000,1643
11.0,90000,3,0.175,126,45000,43986,64463,45000,1014
3.0,90000,5,0.15,210,45000,44564,88772,42993,-1571
6.0,90000,3,0.15,126,45000,43895,87097,44441,546
15.0,90000,3,0.1,126,45000,43645,89882,43479,-166
10.0,90000,3,0.175,126,45000,43880,66921,45000,1120
5.0,90000,3,0.125,126,45000,44175,89672,43712,-463
14.0,90000,3,0.1,126,45000,43846,89895,43904,58
8.0,90000,5,0.05,210,45000,43797,90000,43797,0
7.0,90000,5,0.1,210,45000,44097,89980,44077,-20
12.0,90000,3,0.175,126,45000,43862,61312,45000,1138
4.0,90000,5,0.2,210,45000,43476,74306,44995,1519
9.0,90000,5,0.025,210,45000,44004,90000,44004,0
13.0,90000,3,0.175,126,45000,43546,58665,45000,1454
3.0,90000,5,0.175,210,45000,44564,85087,44371,-193
11.0,90000,3,0.2,126,45000,43986,50351,45000,1014
6.0,90000,3,0.175,126,45000,43895,79000,44990,1095
2.0,90000,3,0.1,126,45000,42492,89960,42423,-69
10.0,90000,3,0.2,126,45000,43880,52431,45000,1120
8.0,90000,5,0.075,210,45000,43797,90000,43797,0
7.0,90000,5,0.125,210,45000,44097,89541,43124,-973
15.0,90000,3,0.125,126,45000,43645,87091,44853,1208
5.0,90000,3,0.15,126,45000,44175,87755,44102,-73
4.0,90000,5,0.225,210,45000,43476,62506,44999,1523
9.0,90000,5,0.05,210,45000,44004,90000,44004,0
12.0,90000,3,0.2,126,45000,43862,48579,45000,1138
14.0,90000,3,0.125,126,45000,43846,87675,44728,882
3.0,90000,5,0.2,210,45000,44564,78194,44978,414
13.0,90000,3,0.2,126,45000,43546,47513,45000,1454
11.0,90000,3,0.225,126,45000,43986,45663,44999,1013
8.0,90000,5,0.1,210,45000,43797,89977,43774,-23
7.0,90000,5,0.15,210,45000,44097,86463,44903,806
6.0,90000,3,0.2,126,45000,43895,65436,45000,1105
10.0,90000,3,0.225,126,45000,43880,46199,45000,1120
4.0,90000,5,0.25,210,45000,43476,52824,44994,1518
2.0,90000,3,0.125,126,45000,42492,89708,41958,-534
5.0,90000,3,0.175,126,45000,44175,81840,44966,791
9.0,90000,5,0.075,210,45000,44004,90000,44004,0
15.0,90000,3,0.15,126,45000,43645,73694,45000,1355
12.0,90000,3,0.225,126,45000,43862,45330,44999,1137
3.0,90000,5,0.225,210,45000,44564,68140,44995,431
14.0,90000,3,0.15,126,45000,43846,75665,45000,1154
8.0,90000,5,0.125,210,45000,43797,89412,44261,464
13.0,90000,3,0.225,126,45000,43546,45179,44999,1453
7.0,90000,5,0.175,210,45000,44097,76604,45000,903
11.0,90000,3,0.25,126,45000,43986,45044,45000,1014
4.0,90000,6,0.025,252,45000,43632,90000,43632,0
10.0,90000,3,0.25,126,45000,43880,45091,45000,1120
6.0,90000,3,0.225,126,45000,43895,53486,45000,1105
9.0,90000,5,0.1,210,45000,44004,89971,43976,-28
3.0,90000,5,0.25,210,45000,44564,57652,44992,428
5.0,90000,3,0.2,126,45000,44175,70136,45000,825
12.0,90000,3,0.25,126,45000,43862,45023,44999,1137
15.0,90000,3,0.175,126,45000,43645,54331,45000,1355
8.0,90000,5,0.15,210,45000,43797,85409,44942,1145
7.0,90000,5,0.2,210,45000,44097,61628,45000,903
2.0,90000,3,0.15,126,45000,42492,88770,42381,-111
13.0,90000,3,0.25,126,45000,43546,45008,45000,1454
14.0,90000,3,0.175,126,45000,43846,56364,45000,1154
11.0,90000,4,0.025,168,45000,44136,90000,44136,0
4.0,90000,6,0.05,252,45000,43632,89999,43631,-1
10.0,90000,4,0.025,168,45000,43947,90000,43947,0
6.0,90000,3,0.25,126,45000,43895,47236,44994,1099
3.0,90000,6,0.025,252,45000,43065,90000,43065,0
9.0,90000,5,0.125,210,45000,44004,89222,44050,46
8.0,90000,5,0.175,210,45000,43797,73658,45000,1203
7.0,90000,5,0.225,210,45000,44097,50705,45000,903
5.0,90000,3,0.225,126,45000,44175,57431,45000,825
12.0,90000,4,0.025,168,45000,44315,90000,44315,0
15.0,90000,3,0.2,126,45000,43645,46088,45000,1355
4.0,90000,6,0.075,252,45000,43632,89998,43630,-2
13.0,90000,4,0.025,168,45000,44513,90000,44513,0
14.0,90000,3,0.2,126,45000,43846,46704,45000,1154
11.0,90000,4,0.05,168,45000,44136,90000,44136,0
2.0,90000,3,0.175,126,45000,42492,86693,42457,-35
8.0,90000,5,0.2,210,45000,43797,58095,45000,1203
7.0,90000,5,0.25,210,45000,44097,46235,45000,903
3.0,90000,6,0.05,252,45000,43065,90000,43065,0
9.0,90000,5,0.15,210,45000,44004,84254,44982,978
10.0,90000,4,0.05,168,45000,43947,90000,43947,0
6.0,90000,4,0.025,168,45000,44308,90000,44308,0
5.0,90000,3,0.25,126,45000,44175,49776,44996,821
4.0,90000,6,0.1,252,45000,43632,89975,43599,-33
15.0,90000,3,0.225,126,45000,43645,45036,44999,1354
12.0,90000,4,0.05,168,45000,44315,90000,44315,0
8.0,90000,5,0.225,210,45000,43797,48610,45000,1203
7.0,90000,6,0.025,252,45000,44386,90000,44386,0
14.0,90000,3,0.225,126,45000,43846,45087,44999,1153
13.0,90000,4,0.05,168,45000,44513,90000,44513,0
11.0,90000,4,0.075,168,45000,44136,89998,44134,-2
3.0,90000,6,0.075,252,45000,43065,89997,43062,-3
9.0,90000,5,0.175,210,45000,44004,70687,45000,996
10.0,90000,4,0.075,168,45000,43947,89999,43946,-1
6.0,90000,4,0.05,168,45000,44308,90000,44308,0
8.0,90000,5,0.25,210,45000,43797,45555,45000,1203
15.0,90000,3,0.25,126,45000,43645,44999,44999,1354
5.0,90000,4,0.025,168,45000,44468,90000,44468,0
7.0,90000,6,0.05,252,45000,44386,90000,44386,0
12.0,90000,4,0.075,168,45000,44315,89999,44315,0
14.0,90000,3,0.25,126,45000,43846,45004,45000,1154
11.0,90000,4,0.1,168,45000,44136,89945,44082,-54
13.0,90000,4,0.075,168,45000,44513,89999,44513,0
9.0,90000,5,0.2,210,45000,44004,54975,45000,996
8.0,90000,6,0.025,252,45000,44401,90000,44401,0
10.0,90000,4,0.1,168,45000,43947,89961,43909,-38
6.0,90000,4,0.075,168,45000,44308,90000,44308,0
7.0,90000,6,0.075,252,45000,44386,90000,44386,0
5.0,90000,4,0.05,168,45000,44468,90000,44468,0
15.0,90000,4,0.025,168,45000,44790,90000,44790,0
12.0,90000,4,0.1,168,45000,44315,89947,44315,0
9.0,90000,5,0.225,210,45000,44004,47155,45000,996
8.0,90000,6,0.05,252,45000,44401,90000,44401,0
11.0,90000,4,0.125,168,45000,44136,88919,44582,446
14.0,90000,4,0.025,168,45000,43414,90000,43414,0
13.0,90000,4,0.1,168,45000,44513,89927,44513,0
7.0,90000,6,0.1,252,45000,44386,89973,44360,-26
10.0,90000,4,0.125,168,45000,43947,89155,44379,432
6.0,90000,4,0.1,168,45000,44308,89976,44285,-23
9.0,90000,5,0.25,210,45000,44004,45245,45000,996
8.0,90000,6,0.075,252,45000,44401,90000,44401,0
12.0,90000,4,0.125,168,45000,44315,88715,44883,568
15.0,90000,4,0.05,168,45000,44790,90000,44790,0
7.0,90000,6,0.125,252,45000,44386,89545,41925,-2461
11.0,90000,4,0.15,168,45000,44136,81550,45000,864
13.0,90000,4,0.125,168,45000,44513,88346,45000,487
14.0,90000,4,0.05,168,45000,43414,90000,43414,0
10.0,90000,4,0.15,168,45000,43947,83005,45000,1053
9.0,90000,6,0.025,252,45000,44548,90000,44548,0
8.0,90000,6,0.1,252,45000,44401,89965,44366,-35
6.0,90000,4,0.125,168,45000,44308,89680,43770,-538
7.0,90000,6,0.15,252,45000,44386,86508,44848,462
12.0,90000,4,0.15,168,45000,44315,80002,45000,685
15.0,90000,4,0.075,168,45000,44790,90000,44790,0
11.0,90000,4,0.175,168,45000,44136,65209,45000,864
13.0,90000,4,0.15,168,45000,44513,78186,45000,487
9.0,90000,6,0.05,252,45000,44548,90000,44548,0
14.0,90000,4,0.075,168,45000,43414,89999,43413,-1
8.0,90000,6,0.125,252,45000,44401,89424,44172,-229
10.0,90000,4,0.175,168,45000,43947,67847,45000,1053
7.0,90000,6,0.175,252,45000,44386,77024,44999,613
6.0,90000,4,0.15,168,45000,44308,87344,44664,356
12.0,90000,4,0.175,168,45000,44315,61920,45000,685
11.0,90000,4,0.2,168,45000,44136,50440,45000,864
8.0,90000,6,0.15,252,45000,44401,85541,44923,522
9.0,90000,6,0.075,252,45000,44548,90000,44548,0
15.0,90000,4,0.1,168,45000,44790,89915,44790,0
13.0,90000,4,0.175,168,45000,44513,59213,45000,487
7.0,90000,6,0.2,252,45000,44386,61895,45000,614
10.0,90000,4,0.2,168,45000,43947,52531,45000,1053
14.0,90000,4,0.1,168,45000,43414,89927,44660,1246
6.0,90000,4,0.175,168,45000,44308,79645,45000,692
8.0,90000,6,0.175,252,45000,44401,74133,45000,599
12.0,90000,4,0.2,168,45000,44315,48907,45000,685
11.0,90000,4,0.225,168,45000,44136,45700,45000,864
9.0,90000,6,0.1,252,45000,44548,89963,44455,-93
13.0,90000,4,0.2,168,45000,44513,47612,45000,487
10.0,90000,4,0.225,168,45000,43947,46305,45000,1053
15.0,90000,4,0.125,168,45000,44790,87607,45000,210
8.0,90000,6,0.2,252,45000,44401,58341,45000,599
14.0,90000,4,0.125,168,45000,43414,87984,45000,1586
6.0,90000,4,0.2,168,45000,44308,66214,45000,692
9.0,90000,6,0.125,252,45000,44548,89266,44061,-487
12.0,90000,4,0.225,168,45000,44315,45381,45000,685
11.0,90000,4,0.25,168,45000,44136,45040,45000,864
13.0,90000,4,0.225,168,45000,44513,45187,45000,487
8.0,90000,6,0.225,252,45000,44401,48491,45000,599
10.0,90000,4,0.25,168,45000,43947,45084,45000,1053
15.0,90000,4,0.15,168,45000,44790,74406,45000,210
6.0,90000,4,0.225,168,45000,44308,53712,45000,692
14.0,90000,4,0.15,168,45000,43414,76249,45000,1586
9.0,90000,6,0.15,252,45000,44548,84413,44978,430
12.0,90000,4,0.25,168,45000,44315,45009,44999,684
8.0,90000,6,0.25,252,45000,44401,45533,45000,599
11.0,90000,5,0.025,210,45000,44329,90000,44329,0
13.0,90000,4,0.25,168,45000,44513,45004,45000,487
10.0,90000,5,0.025,210,45000,43399,90000,43399,0
15.0,90000,4,0.175,168,45000,44790,54824,45000,210
9.0,90000,6,0.175,252,45000,44548,71194,45000,452
8.0,90000,7,0.025,294,45000,43917,90000,43917,0
14.0,90000,4,0.175,168,45000,43414,57020,45000,1586
12.0,90000,5,0.025,210,45000,44685,90000,44685,0
11.0,90000,5,0.05,210,45000,44329,90000,44329,0
14.0,90000,4,0.2,168,45000,43414,46788,45000,1586
9.0,90000,6,0.2,252,45000,44548,55073,45000,452
6.0,90000,4,0.25,168,45000,44308,47433,45000,692
15.0,90000,4,0.2,168,45000,44790,46221,45000,210
4.0,90000,6,0.125,252,45000,43632,89746,42923,-709
5.0,90000,4,0.075,168,45000,44468,89999,44467,-1
10.0,90000,5,0.05,210,45000,43399,90000,43399,0
11.0,90000,5,0.075,210,45000,44329,90000,44329,0
13.0,90000,5,0.025,210,45000,44253,90000,44253,0
7.0,90000,6,0.225,252,45000,44386,50571,45000,614
8.0,90000,7,0.05,294,45000,43917,90000,43917,0
12.0,90000,5,0.05,210,45000,44685,90000,44685,0
2.0,90000,3,0.2,126,45000,42492,81256,44653,2161
3.0,90000,6,0.1,252,45000,43065,89976,43033,-32
14.0,90000,4,0.225,168,45000,43414,45108,45000,1586
9.0,90000,6,0.225,252,45000,44548,47139,45000,452
15.0,90000,4,0.225,168,45000,44790,45056,45000,210
6.0,90000,5,0.025,210,45000,44121,90000,44121,0
11.0,90000,5,0.1,210,45000,44329,89949,44278,-51
10.0,90000,5,0.075,210,45000,43399,90000,43399,0
13.0,90000,5,0.05,210,45000,44253,90000,44253,0
5.0,90000,4,0.1,168,45000,44468,89985,44418,-50
4.0,90000,6,0.15,252,45000,43632,88379,43903,271
7.0,90000,6,0.25,252,45000,44386,46156,44999,613
8.0,90000,7,0.075,294,45000,43917,89997,43914,-3
12.0,90000,5,0.075,210,45000,44685,90000,44685,0
1.0,90000,0,0.025,0,45160,45158,89999,45157,-1
9.0,90000,6,0.25,252,45000,44548,45234,45000,452
14.0,90000,4,0.25,168,45000,43414,45002,45000,1586
15.0,90000,4,0.25,168,45000,44790,45000,45000,210
6.0,90000,5,0.05,210,45000,44121,90000,44121,0
13.0,90000,5,0.075,210,45000,44253,90000,44253,0
10.0,90000,5,0.1,210,45000,43399,89966,43366,-33
11.0,90000,5,0.125,210,45000,44329,88825,44549,220
5.0,90000,4,0.125,168,45000,44468,89744,44060,-408
8.0,90000,7,0.1,294,45000,43917,89957,43804,-113
4.0,90000,6,0.175,252,45000,43632,83990,44909,1277
7.0,90000,7,0.025,294,45000,43917,90000,43917,0
12.0,90000,5,0.1,210,45000,44685,89940,44625,-60
2.0,90000,3,0.225,126,45000,42492,73663,44940,2448
3.0,90000,6,0.125,252,45000,43065,89770,42289,-776
9.0,90000,7,0.025,294,45000,44302,90000,44302,0
14.0,90000,5,0.025,210,45000,44709,90000,44709,0
15.0,90000,5,0.025,210,45000,44790,90000,44790,0
11.0,90000,5,0.15,210,45000,44329,81424,44973,644
6.0,90000,5,0.075,210,45000,44121,90000,44121,0
13.0,90000,5,0.1,210,45000,44253,89916,44253,0
10.0,90000,5,0.125,210,45000,43399,89050,43849,450
5.0,90000,4,0.15,168,45000,44468,87837,44254,-214
8.0,90000,7,0.125,294,45000,43917,89367,43823,-94
4.0,90000,6,0.2,252,45000,43632,74496,44994,1362
7.0,90000,7,0.05,294,45000,43917,90000,43917,0
12.0,90000,5,0.125,210,45000,44685,88536,44621,-64
9.0,90000,7,0.05,294,45000,44302,90000,44302,0
14.0,90000,5,0.05,210,45000,44709,90000,44709,0
15.0,90000,5,0.05,210,45000,44790,90000,44790,0
11.0,90000,5,0.175,210,45000,44329,64540,45000,671
13.0,90000,5,0.125,210,45000,44253,88203,44836,583
6.0,90000,5,0.1,210,45000,44121,89971,44095,-26
10.0,90000,5,0.15,210,45000,43399,82903,44980,1581
5.0,90000,4,0.175,168,45000,44468,81999,44983,515
8.0,90000,7,0.15,294,45000,43917,85032,44963,1046
4.0,90000,6,0.225,252,45000,43632,62562,44997,1365
1.0,90000,0,0.05,0,45160,45158,89996,45155,-3
7.0,90000,7,0.075,294,45000,43917,89998,43916,-1
12.0,90000,5,0.15,210,45000,44685,79656,45000,315
2.0,90000,3,0.25,126,45000,42492,65823,44967,2475
3.0,90000,6,0.15,252,45000,43065,88797,41707,-1358
9.0,90000,7,0.075,294,45000,44302,89998,44300,-2
14.0,90000,5,0.075,210,45000,44709,90000,44709,0
11.0,90000,5,0.2,210,45000,44329,50413,45000,671
15.0,90000,5,0.075,210,45000,44790,90000,44790,0
13.0,90000,5,0.15,210,45000,44253,77869,45000,747
6.0,90000,5,0.125,210,45000,44121,89635,43281,-840
10.0,90000,5,0.175,210,45000,43399,67071,45000,1601
5.0,90000,4,0.2,168,45000,44468,70412,44999,531
8.0,90000,7,0.175,294,45000,43917,72431,45000,1083
4.0,90000,6,0.25,252,45000,43632,52661,44988,1356
12.0,90000,5,0.175,210,45000,44685,61243,45000,315
7.0,90000,7,0.1,294,45000,43917,89974,43892,-25
9.0,90000,7,0.1,294,45000,44302,89952,44256,-46
11.0,90000,5,0.225,210,45000,44329,45706,45000,671
14.0,90000,5,0.1,210,45000,44709,89911,44573,-136
13.0,90000,5,0.175,210,45000,44253,58755,45000,747
15.0,90000,5,0.1,210,45000,44790,89891,44628,-162
6.0,90000,5,0.15,210,45000,44121,87224,44628,507
10.0,90000,5,0.2,210,45000,43399,52562,45000,1601
5.0,90000,4,0.225,168,45000,44468,57859,44997,529
8.0,90000,7,0.2,294,45000,43917,56983,45000,1083
2.0,90000,4,0.025,168,45000,42812,90000,42812,0
4.0,90000,7,0.025,294,45000,43762,90000,43762,0
3.0,90000,6,0.175,252,45000,43065,85233,44626,1561
12.0,90000,5,0.2,210,45000,44685,48850,45000,315
7.0,90000,7,0.125,294,45000,43917,89495,43145,-772
9.0,90000,7,0.125,294,45000,44302,89188,43858,-444
1.0,90000,0,0.075,0,45160,45158,89973,45133,-25
11.0,90000,5,0.25,210,45000,44329,45047,45000,671
14.0,90000,5,0.125,210,45000,44709,87808,44910,201
13.0,90000,5,0.2,210,45000,44253,47588,45000,747
15.0,90000,5,0.125,210,45000,44790,87392,45000,210
10.0,90000,5,0.225,210,45000,43399,46300,45000,1601
6.0,90000,5,0.175,210,45000,44121,78917,45000,879
5.0,90000,4,0.25,168,45000,44468,49625,44997,529
8.0,90000,7,0.225,294,45000,43917,48111,45000,1083
4.0,90000,7,0.05,294,45000,43762,90000,43762,0
12.0,90000,5,0.225,210,45000,44685,45370,45000,315
7.0,90000,7,0.15,294,45000,43917,86147,44853,936
9.0,90000,7,0.15,294,45000,44302,83761,44979,677
11.0,90000,6,0.025,252,45000,44686,90000,44686,0
14.0,90000,5,0.15,210,45000,44709,75892,45000,291
13.0,90000,5,0.225,210,45000,44253,45167,45000,747
10.0,90000,5,0.25,210,45000,43399,45102,45000,1601
15.0,90000,5,0.15,210,45000,44790,74035,45000,210
6.0,90000,5,0.2,210,45000,44121,65576,45000,879
8.0,90000,7,0.25,294,45000,43917,45467,44999,1082
5.0,90000,5,0.025,210,45000,44143,90000,44143,0
2.0,90000,4,0.05,168,45000,42812,90000,42812,0
3.0,90000,6,0.2,252,45000,43065,78318,44967,1902
12.0,90000,5,0.25,210,45000,44685,45029,45000,315
4.0,90000,7,0.075,294,45000,43762,89998,43760,-2
9.0,90000,7,0.175,294,45000,44302,69354,45000,698
7.0,90000,7,0.175,294,45000,43917,75776,45000,1083
11.0,90000,6,0.05,252,45000,44686,90000,44686,0
13.0,90000,5,0.25,210,45000,44253,45011,45000,747
14.0,90000,5,0.175,210,45000,44709,56495,45000,291
15.0,90000,5,0.175,210,45000,44790,54340,45000,210
10.0,90000,6,0.025,252,45000,44247,90000,44247,0
6.0,90000,5,0.225,210,45000,44121,53728,45000,879
8.0,90000,8,0.025,336,45000,44172,90000,44172,0
5.0,90000,5,0.05,210,45000,44143,90000,44143,0
12.0,90000,6,0.025,252,45000,44612,90000,44612,0
4.0,90000,7,0.1,294,45000,43762,89978,43743,-19
1.0,90000,0,0.1,0,45160,45158,89865,45033,-125
9.0,90000,7,0.2,294,45000,44302,53764,45000,698
7.0,90000,7,0.2,294,45000,43917,60523,45000,1083
11.0,90000,6,0.075,252,45000,44686,90000,44686,0
14.0,90000,5,0.2,210,45000,44709,46746,45000,291
13.0,90000,6,0.025,252,45000,44657,90000,44657,0
15.0,90000,5,0.2,210,45000,44790,46137,45000,210
6.0,90000,5,0.25,210,45000,44121,47298,44999,878
3.0,90000,6,0.225,252,45000,43065,68205,44991,1926
10.0,90000,6,0.05,252,45000,44247,90000,44247,0
2.0,90000,4,0.075,168,45000,42812,89999,42808,-4
8.0,90000,8,0.05,336,45000,44172,90000,44172,0
5.0,90000,5,0.075,210,45000,44143,90000,44143,0
9.0,90000,7,0.225,294,45000,44302,46909,45000,698
12.0,90000,6,0.05,252,45000,44612,90000,44612,0
4.0,90000,7,0.125,294,45000,43762,89729,43185,-577
7.0,90000,7,0.225,294,45000,43917,50114,44998,1081
11.0,90000,6,0.1,252,45000,44686,89937,44623,-63
14.0,90000,5,0.225,210,45000,44709,45088,45000,291
13.0,90000,6,0.05,252,45000,44657,90000,44657,0
15.0,90000,5,0.225,210,45000,44790,45053,45000,210
6.0,90000,6,0.025,252,45000,44315,90000,44315,0
10.0,90000,6,0.075,252,45000,44247,90000,44247,0
9.0,90000,7,0.25,294,45000,44302,45192,44999,697
5.0,90000,5,0.1,210,45000,44143,89980,44123,-20
8.0,90000,8,0.075,336,45000,44172,90000,44172,0
4.0,90000,7,0.15,294,45000,43762,88179,43790,28
12.0,90000,6,0.075,252,45000,44612,89999,44611,-1
7.0,90000,7,0.25,294,45000,43917,45986,44997,1080
11.0,90000,6,0.125,252,45000,44686,88870,44619,-67
14.0,90000,5,0.25,210,45000,44709,45003,44999,290
3.0,90000,6,0.25,252,45000,43065,57593,44981,1916
13.0,90000,6,0.075,252,45000,44657,89999,44656,-1
15.0,90000,5,0.25,210,45000,44790,45000,45000,210
2.0,90000,4,0.1,168,45000,42812,89971,42774,-38
1.0,90000,0,0.125,0,45160,45158,89487,44675,-483
6.0,90000,6,0.05,252,45000,44315,90000,44315,0
10.0,90000,6,0.1,252,45000,44247,89946,44194,-53
9.0,90000,8,0.025,336,45000,44452,90000,44452,0
5.0,90000,5,0.125,210,45000,44143,89719,43701,-442
8.0,90000,8,0.1,336,45000,44172,89970,44094,-78
4.0,90000,7,0.175,294,45000,43762,83458,44870,1108
12.0,90000,6,0.1,252,45000,44612,89943,44435,-177
11.0,90000,6,0.15,252,45000,44686,81538,45000,314
7.0,90000,8,0.025,336,45000,44094,90000,44094,0
14.0,90000,6,0.025,252,45000,44572,90000,44572,0
13.0,90000,6,0.1,252,45000,44657,89913,44570,-87
15.0,90000,6,0.025,252,45000,44744,90000,44744,0
6.0,90000,6,0.075,252,45000,44315,90000,44315,0
10.0,90000,6,0.125,252,45000,44247,89139,44143,-104
9.0,90000,8,0.05,336,45000,44452,90000,44452,0
5.0,90000,5,0.15,210,45000,44143,87839,44380,237
8.0,90000,8,0.125,336,45000,44172,89332,43937,-235
3.0,90000,7,0.025,294,45000,42719,90000,42719,0
4.0,90000,7,0.2,294,45000,43762,73876,45000,1238
12.0,90000,6,0.125,252,45000,44612,88561,44500,-112
11.0,90000,6,0.175,252,45000,44686,65227,45000,314
14.0,90000,6,0.05,252,45000,44572,90000,44572,0
2.0,90000,4,0.125,168,45000,42812,89769,42394,-418
7.0,90000,8,0.05,336,45000,44094,90000,44094,0
13.0,90000,6,0.125,252,45000,44657,88283,44920,263
15.0,90000,6,0.05,252,45000,44744,90000,44744,0
6.0,90000,6,0.1,252,45000,44315,89974,44291,-24
9.0,90000,8,0.075,336,45000,44452,89999,44451,-1
10.0,90000,6,0.15,252,45000,44247,83041,44975,728
1.0,90000,0,0.15,0,45160,45158,88365,43610,-1548
5.0,90000,5,0.175,210,45000,44143,81752,44964,821
8.0,90000,8,0.15,336,45000,44172,85013,44879,707
11.0,90000,6,0.2,252,45000,44686,50421,45000,314
4.0,90000,7,0.225,294,45000,43762,61902,44998,1236
12.0,90000,6,0.15,252,45000,44612,79967,45000,388
14.0,90000,6,0.075,252,45000,44572,89998,44570,-2
13.0,90000,6,0.15,252,45000,44657,78218,45000,343
7.0,90000,8,0.075,336,45000,44094,90000,44094,0
15.0,90000,6,0.075,252,45000,44744,89998,44742,-2
6.0,90000,6,0.125,252,45000,44315,89609,43539,-776
9.0,90000,8,0.1,336,45000,44452,89967,44363,-89
10.0,90000,6,0.175,252,45000,44247,67597,45000,753
3.0,90000,7,0.05,294,45000,42719,90000,42719,0
5.0,90000,5,0.2,210,45000,44143,70172,45000,857
8.0,90000,8,0.175,336,45000,44172,73055,45000,828
11.0,90000,6,0.225,252,45000,44686,45727,45000,314
2.0,90000,4,0.15,168,45000,42812,88844,42566,-246
4.0,90000,7,0.25,294,45000,43762,52324,44994,1232
12.0,90000,6,0.175,252,45000,44612,61969,45000,388
14.0,90000,6,0.1,252,45000,44572,89903,44475,-97
13.0,90000,6,0.175,252,45000,44657,59410,45000,343
7.0,90000,8,0.1,336,45000,44094,89976,44071,-23
15.0,90000,6,0.1,252,45000,44744,89891,44636,-108
9.0,90000,8,0.125,336,45000,44452,89149,44072,-380
6.0,90000,6,0.15,252,45000,44315,87203,44749,434
10.0,90000,6,0.2,252,45000,44247,52611,45000,753
5.0,90000,5,0.225,210,45000,44143,57725,44999,856
11.0,90000,6,0.25,252,45000,44686,45042,45000,314
8.0,90000,8,0.2,336,45000,44172,57585,45000,828
4.0,90000,8,0.025,336,45000,43202,90000,43202,0
12.0,90000,6,0.2,252,45000,44612,48934,45000,388
1.0,90000,0,0.175,0,45160,45158,87020,42360,-2798
14.0,90000,6,0.125,252,45000,44572,87883,44963,391
13.0,90000,6,0.2,252,45000,44657,47763,45000,343
7.0,90000,8,0.125,336,45000,44094,89489,43594,-500
15.0,90000,6,0.125,252,45000,44744,87510,44910,166
9.0,90000,8,0.15,336,45000,44452,83838,45000,548
3.0,90000,7,0.075,294,45000,42719,89998,42717,-2
6.0,90000,6,0.175,252,45000,44315,79275,45000,685
10.0,90000,6,0.225,252,45000,44247,46249,45000,753
2.0,90000,4,0.175,168,45000,42812,86839,42581,-231
5.0,90000,5,0.25,210,45000,44143,49903,44997,854
11.0,90000,7,0.025,294,45000,43800,90000,43800,0
8.0,90000,8,0.225,336,45000,44172,48290,45000,828
12.0,90000,6,0.225,252,45000,44612,45399,45000,388
4.0,90000,8,0.05,336,45000,43202,90000,43202,0
13.0,90000,6,0.225,252,45000,44657,45213,45000,343
14.0,90000,6,0.15,252,45000,44572,76206,45000,428
9.0,90000,8,0.175,336,45000,44452,70084,45000,548
7.0,90000,8,0.15,336,45000,44094,86186,44830,736
15.0,90000,6,0.15,252,45000,44744,74350,45000,256
6.0,90000,6,0.2,252,45000,44315,65869,44999,684
10.0,90000,6,0.25,252,45000,44247,45106,45000,753
11.0,90000,7,0.05,294,45000,43800,90000,43800,0
5.0,90000,6,0.025,252,45000,44175,90000,44175,0
8.0,90000,8,0.25,336,45000,44172,45509,44999,827
12.0,90000,6,0.25,252,45000,44612,45022,45000,388
13.0,90000,6,0.25,252,45000,44657,45006,44999,342
4.0,90000,8,0.075,336,45000,43202,89998,43200,-2
14.0,90000,6,0.175,252,45000,44572,57080,45000,428
3.0,90000,7,0.1,294,45000,42719,89973,42660,-59
9.0,90000,8,0.2,336,45000,44452,54487,45000,548
15.0,90000,6,0.175,252,45000,44744,54962,45000,256
7.0,90000,8,0.175,336,45000,44094,76175,45000,906
1.0,90000,0,0.2,0,45160,45158,82813,38625,-6533
6.0,90000,6,0.225,252,45000,44315,53583,44999,684
10.0,90000,7,0.025,294,45000,44388,90000,44388,0
2.0,90000,4,0.2,168,45000,42812,81318,44711,1899
11.0,90000,7,0.075,294,45000,43800,89999,43799,-1
5.0,90000,6,0.05,252,45000,44175,90000,44175,0
12.0,90000,7,0.025,294,45000,44213,90000,44213,0
8.0,90000,9,0.025,378,45000,44672,90000,44672,0
13.0,90000,7,0.025,294,45000,44525,90000,44525,0
14.0,90000,6,0.2,252,45000,44572,46887,45000,428
4.0,90000,8,0.1,336,45000,43202,89981,43168,-34
9.0,90000,8,0.225,336,45000,44452,47004,45000,548
15.0,90000,6,0.2,252,45000,44744,46245,45000,256
6.0,90000,6,0.25,252,45000,44315,47177,44997,682
7.0,90000,8,0.2,336,45000,44094,61224,45000,906
10.0,90000,7,0.05,294,45000,44388,90000,44388,0
11.0,90000,7,0.1,294,45000,43800,89934,43736,-64
5.0,90000,6,0.075,252,45000,44175,90000,44175,0
12.0,90000,7,0.05,294,45000,44213,90000,44213,0
3.0,90000,7,0.125,294,45000,42719,89722,42319,-400
8.0,90000,9,0.05,378,45000,44672,90000,44672,0
13.0,90000,7,0.05,294,45000,44525,90000,44525,0
14.0,90000,6,0.225,252,45000,44572,45105,45000,428
9.0,90000,8,0.25,336,45000,44452,45227,45000,548
4.0,90000,8,0.125,336,45000,43202,89731,42165,-1037
15.0,90000,6,0.225,252,45000,44744,45052,45000,256
6.0,90000,7,0.025,294,45000,44207,90000,44207,0
2.0,90000,4,0.225,168,45000,42812,74108,44945,2133
7.0,90000,8,0.225,336,45000,44094,50245,45000,906
10.0,90000,7,0.075,294,45000,44388,89999,44387,-1
11.0,90000,7,0.125,294,45000,43800,88755,44800,1000
1.0,90000,0,0.225,0,45160,45158,78091,45020,-138
12.0,90000,7,0.075,294,45000,44213,89999,44212,-1
5.0,90000,6,0.1,252,45000,44175,89976,44140,-35
14.0,90000,6,0.25,252,45000,44572,45002,45000,428
13.0,90000,7,0.075,294,45000,44525,89999,44524,-1
8.0,90000,9,0.075,378,45000,44672,90000,44672,0
9.0,90000,9,0.025,378,45000,43920,90000,43920,0
4.0,90000,8,0.15,336,45000,43202,88156,43894,692
15.0,90000,6,0.25,252,45000,44744,45001,45000,256
6.0,90000,7,0.05,294,45000,44207,90000,44207,0
7.0,90000,8,0.25,336,45000,44094,46135,44999,905
3.0,90000,7,0.15,294,45000,42719,88680,42331,-388
10.0,90000,7,0.1,294,45000,44388,89954,44311,-77
11.0,90000,7,0.15,294,45000,43800,80705,45000,1200
12.0,90000,7,0.1,294,45000,44213,89926,44022,-191
5.0,90000,6,0.125,252,45000,44175,89694,43780,-395
14.0,90000,7,0.025,294,45000,44284,90000,44284,0
13.0,90000,7,0.1,294,45000,44525,89922,44359,-166
9.0,90000,9,0.05,378,45000,43920,90000,43920,0
8.0,90000,9,0.1,378,45000,44672,89966,44615,-57
15.0,90000,7,0.025,294,45000,44205,90000,44205,0
4.0,90000,8,0.175,336,45000,43202,83614,44890,1688
2.0,90000,4,0.25,168,45000,42812,65729,44958,2146
6.0,90000,7,0.075,294,45000,44207,90000,44207,0
7.0,90000,9,0.025,378,45000,44023,90000,44023,0
11.0,90000,7,0.175,294,45000,43800,63038,45000,1200
10.0,90000,7,0.125,294,45000,44388,88974,42282,-2106
12.0,90000,7,0.125,294,45000,44213,88420,44854,641
5.0,90000,6,0.15,252,45000,44175,87870,44383,208
14.0,90000,7,0.05,294,45000,44284,90000,44284,0
9.0,90000,9,0.075,378,45000,43920,90000,43920,0
13.0,90000,7,0.125,294,45000,44525,88000,44666,141
1.0,90000,0,0.25,0,45160,45158,71965,44951,-207
8.0,90000,9,0.125,378,45000,44672,89431,43816,-856
15.0,90000,7,0.05,294,45000,44205,90000,44205,0
4.0,90000,8,0.2,336,45000,43202,74100,44995,1793
3.0,90000,7,0.175,294,45000,42719,84764,44497,1778
6.0,90000,7,0.1,294,45000,44207,89972,44179,-28
11.0,90000,7,0.2,294,45000,43800,49645,45000,1200
7.0,90000,9,0.05,378,45000,44023,90000,44023,0
10.0,90000,7,0.15,294,45000,44388,82292,45000,612
12.0,90000,7,0.15,294,45000,44213,78884,45000,787
9.0,90000,9,0.1,378,45000,43920,89963,43857,-63
14.0,90000,7,0.075,294,45000,44284,89999,44284,0
5.0,90000,6,0.175,252,45000,44175,81950,44955,780
13.0,90000,7,0.15,294,45000,44525,76865,45000,475
2.0,90000,5,0.025,210,45001,42789,90000,42789,0
8.0,90000,9,0.15,378,45000,44672,85485,44837,165
15.0,90000,7,0.075,294,45000,44205,89999,44205,0
4.0,90000,8,0.225,336,45000,43202,62124,45000,1798
6.0,90000,7,0.125,294,45000,44207,89595,43155,-1052
11.0,90000,7,0.225,294,45000,43800,45596,45000,1200
7.0,90000,9,0.075,378,45000,44023,90000,44023,0
10.0,90000,7,0.175,294,45000,44388,65809,45000,612
12.0,90000,7,0.175,294,45000,44213,59766,45000,787
9.0,90000,9,0.125,378,45000,43920,89291,43595,-325
14.0,90000,7,0.1,294,45000,44284,89901,44284,0
13.0,90000,7,0.175,294,45000,44525,57204,45000,475
5.0,90000,6,0.2,252,45000,44175,70255,45000,825
8.0,90000,9,0.175,378,45000,44672,74310,45000,328
15.0,90000,7,0.1,294,45000,44205,89880,44205,0
4.0,90000,8,0.25,336,45000,43202,52415,44996,1794
3.0,90000,7,0.2,294,45000,42719,77846,44970,2251
6.0,90000,7,0.15,294,45000,44207,87068,44617,410
11.0,90000,7,0.25,294,45000,43800,45039,45000,1200
1.0,90000,1,0.025,42,45174,45146,90000,45146,0
10.0,90000,7,0.2,294,45000,44388,51563,45000,612
7.0,90000,9,0.1,378,45000,44023,89968,43933,-90
12.0,90000,7,0.2,294,45000,44213,48281,45000,787
9.0,90000,9,0.15,378,45000,43920,84395,44933,1013
13.0,90000,7,0.2,294,45000,44525,47144,45000,475
2.0,90000,5,0.05,210,45001,42789,90000,42789,0
14.0,90000,7,0.125,294,45000,44284,87539,44911,627
5.0,90000,6,0.225,252,45000,44175,57770,44998,823
8.0,90000,9,0.2,378,45000,44672,58600,45000,328
15.0,90000,7,0.125,294,45000,44205,87056,45000,795
4.0,90000,9,0.025,378,45000,43614,90000,43614,0
6.0,90000,7,0.175,294,45000,44207,78241,45000,793
11.0,90000,8,0.025,336,45000,44407,90000,44407,0
12.0,90000,7,0.225,294,45000,44213,45334,45000,787
10.0,90000,7,0.225,294,45000,44388,46090,45000,612
9.0,90000,9,0.175,378,45000,43920,71209,45000,1080
7.0,90000,9,0.125,378,45000,44023,89539,42562,-1461
13.0,90000,7,0.225,294,45000,44525,45156,45000,475
14.0,90000,7,0.15,294,45000,44284,74799,45000,716
5.0,90000,6,0.25,252,45000,44175,49709,44997,822
3.0,90000,7,0.225,294,45000,42719,67770,44994,2275
8.0,90000,9,0.225,378,45000,44672,48617,44999,327
15.0,90000,7,0.15,294,45000,44205,72729,45000,795
4.0,90000,9,0.05,378,45000,43614,90000,43614,0
6.0,90000,7,0.2,294,45000,44207,64656,44999,792
11.0,90000,8,0.05,336,45000,44407,90000,44407,0
12.0,90000,7,0.25,294,45000,44213,45020,45000,787
10.0,90000,7,0.25,294,45000,44388,45093,45000,612
9.0,90000,9,0.2,378,45000,43920,55412,45000,1080
2.0,90000,5,0.075,210,45001,42789,89997,42774,-15
13.0,90000,7,0.25,294,45000,44525,45010,45000,475
7.0,90000,9,0.15,378,45000,44023,86559,44740,717
14.0,90000,7,0.175,294,45000,44284,55060,45000,716
5.0,90000,7,0.025,294,45000,44451,90000,44451,0
1.0,90000,1,0.05,42,45174,45146,89996,45143,-3
8.0,90000,9,0.25,378,45000,44672,45538,45000,328
15.0,90000,7,0.175,294,45000,44205,53071,45000,795
6.0,90000,7,0.225,294,45000,44207,52887,44998,791
11.0,90000,8,0.075,336,45000,44407,89999,44406,-1
4.0,90000,9,0.075,378,45000,43614,90000,43614,0
9.0,90000,9,0.225,378,45000,43920,47290,45000,1080
12.0,90000,8,0.025,336,45000,44535,90000,44535,0
3.0,90000,7,0.25,294,45000,42719,57383,44984,2265
10.0,90000,8,0.025,336,45000,44403,90000,44403,0
13.0,90000,8,0.025,336,45000,44539,90000,44539,0
14.0,90000,7,0.2,294,45000,44284,46436,45000,716
7.0,90000,9,0.175,378,45000,44023,77313,45000,977
5.0,90000,7,0.05,294,45000,44451,90000,44451,0
15.0,90000,7,0.2,294,45000,44205,45946,45000,795
6.0,90000,7,0.25,294,45000,44207,46985,44997,790
11.0,90000,8,0.1,336,45000,44407,89938,44347,-60
4.0,90000,9,0.1,378,45000,43614,89976,43581,-33
9.0,90000,9,0.25,378,45000,43920,45232,45000,1080
2.0,90000,5,0.1,210,45001,42789,89973,42709,-80
12.0,90000,8,0.05,336,45000,44535,90000,44535,0
13.0,90000,8,0.05,336,45000,44539,90000,44539,0
10.0,90000,8,0.05,336,45000,44403,90000,44403,0
14.0,90000,7,0.225,294,45000,44284,45080,45000,716
7.0,90000,9,0.2,378,45000,44023,62217,44999,976
15.0,90000,7,0.225,294,45000,44205,45040,45000,795
5.0,90000,7,0.075,294,45000,44451,89998,44449,-2
6.0,90000,8,0.025,336,45000,43805,90000,43805,0
11.0,90000,8,0.125,336,45000,44407,88694,44727,320
4.0,90000,9,0.125,378,45000,43614,89740,43111,-503
3.0,90000,8,0.025,336,45000,42214,90000,42214,0
12.0,90000,8,0.075,336,45000,44535,90000,44535,0
1.0,90000,1,0.075,42,45174,45146,89980,45127,-19
14.0,90000,7,0.25,294,45000,44284,45003,45000,716
13.0,90000,8,0.075,336,45000,44539,89999,44538,-1
10.0,90000,8,0.075,336,45000,44403,89999,44402,-1
15.0,90000,7,0.25,294,45000,44205,45001,45000,795
7.0,90000,9,0.225,378,45000,44023,50794,44999,976
5.0,90000,7,0.1,294,45000,44451,89979,44418,-33
6.0,90000,8,0.05,336,45000,43805,90000,43805,0
11.0,90000,8,0.15,336,45000,44407,80696,45000,593
2.0,90000,5,0.125,210,45001,42789,89758,42169,-620
4.0,90000,9,0.15,378,45000,43614,88356,43355,-259
12.0,90000,8,0.1,336,45000,44535,89919,44335,-200
13.0,90000,8,0.1,336,45000,44539,89888,44296,-243
14.0,90000,8,0.025,336,45000,44156,90000,44156,0
10.0,90000,8,0.1,336,45000,44403,89949,44064,-339
15.0,90000,8,0.025,336,45000,44185,90000,44185,0
7.0,90000,9,0.25,378,45000,44023,46218,45000,977
5.0,90000,7,0.125,294,45000,44451,89675,44060,-391
6.0,90000,8,0.075,336,45000,43805,89999,43804,-1
11.0,90000,8,0.175,336,45000,44407,63820,45000,593
3.0,90000,8,0.05,336,45000,42214,90000,42214,0
4.0,90000,9,0.175,378,45000,43614,84157,44847,1233
12.0,90000,8,0.125,336,45000,44535,88386,44734,199
14.0,90000,8,0.05,336,45000,44156,90000,44156,0
13.0,90000,8,0.125,336,45000,44539,87983,44920,381
10.0,90000,8,0.125,336,45000,44403,88934,44157,-246
15.0,90000,8,0.05,336,45000,44185,90000,44185,0
5.0,90000,7,0.15,294,45000,44451,87697,44293,-158
11.0,90000,8,0.2,336,45000,44407,50026,45000,593
6.0,90000,8,0.1,336,45000,43805,89973,43780,-25
2.0,90000,5,0.15,210,45001,42789,88794,42195,-594
1.0,90000,1,0.1,42,45174,45146,89890,45042,-104
12.0,90000,8,0.15,336,45000,44535,78930,45000,465
4.0,90000,9,0.2,378,45000,43614,74858,44996,1382
14.0,90000,8,0.075,336,45000,44156,89998,44154,-2
13.0,90000,8,0.15,336,45000,44539,76934,45000,461
10.0,90000,8,0.15,336,45000,44403,82428,45000,597
15.0,90000,8,0.075,336,45000,44185,89999,44184,-1
11.0,90000,8,0.225,336,45000,44407,45654,45000,593
5.0,90000,7,0.175,294,45000,44451,81285,45000,549
6.0,90000,8,0.125,336,45000,43805,89575,43027,-778
3.0,90000,8,0.075,336,45000,42214,89996,42212,-2
12.0,90000,8,0.175,336,45000,44535,60619,45000,465
4.0,90000,9,0.225,378,45000,43614,62720,44999,1385
14.0,90000,8,0.1,336,45000,44156,89885,43945,-211
13.0,90000,8,0.175,336,45000,44539,58131,45000,461
10.0,90000,8,0.175,336,45000,44403,66330,45000,597
15.0,90000,8,0.1,336,45000,44185,89859,43783,-402
11.0,90000,8,0.25,336,45000,44407,45041,45000,593
5.0,90000,7,0.2,294,45000,44451,69314,45000,549
6.0,90000,8,0.15,336,45000,43805,86907,44540,735
2.0,90000,5,0.175,210,45001,42789,86688,42226,-563
12.0,90000,8,0.2,336,45000,44535,48569,45000,465
13.0,90000,8,0.2,336,45000,44539,47408,45000,461
4.0,90000,9,0.25,378,45000,43614,52941,44990,1376
14.0,90000,8,0.125,336,45000,44156,87551,44774,618
1.0,90000,1,0.125,42,45174,45146,89509,44683,-463
10.0,90000,8,0.2,336,45000,44403,52047,45000,597
15.0,90000,8,0.125,336,45000,44185,87068,44954,769
3.0,90000,8,0.1,336,45000,42214,89976,42054,-160
11.0,90000,9,0.025,378,45000,44253,90000,44253,0
6.0,90000,8,0.175,336,45000,43805,78514,45000,1195
5.0,90000,7,0.225,294,45000,44451,56989,44999,548
12.0,90000,8,0.225,336,45000,44535,45357,45000,465
13.0,90000,8,0.225,336,45000,44539,45176,45000,461
14.0,90000,8,0.15,336,45000,44156,74760,45000,844
10.0,90000,8,0.225,336,45000,44403,46191,45000,597
15.0,90000,8,0.15,336,45000,44185,72799,45000,815
11.0,90000,9,0.05,378,45000,44253,90000,44253,0
2.0,90000,5,0.2,210,45001,42789,81296,44661,1872
6.0,90000,8,0.2,336,45000,43805,65165,45000,1195
5.0,90000,7,0.25,294,45000,44451,49331,44996,545
12.0,90000,8,0.25,336,45000,44535,45018,45000,465
13.0,90000,8,0.25,336,45000,44539,45007,45000,461
14.0,90000,8,0.175,336,45000,44156,55844,45000,844
3.0,90000,8,0.125,336,45000,42214,89740,42014,-200
10.0,90000,8,0.25,336,45000,44403,45097,45000,597
15.0,90000,8,0.175,336,45000,44185,53876,45000,815
11.0,90000,9,0.075,378,45000,44253,90000,44253,0
6.0,90000,8,0.225,336,45000,43805,53226,45000,1195
5.0,90000,8,0.025,336,45000,44220,90000,44220,0
1.0,90000,1,0.15,42,45174,45146,88450,43679,-1467
12.0,90000,9,0.025,378,45000,44730,90000,44730,0
13.0,90000,9,0.025,378,45000,44528,90000,44528,0
14.0,90000,8,0.2,336,45000,44156,46630,45000,844
15.0,90000,8,0.2,336,45000,44185,46121,45000,815
10.0,90000,9,0.025,378,45000,44346,90000,44346,0
2.0,90000,5,0.225,210,45001,42789,73989,44934,2145
11.0,90000,9,0.1,378,45000,44253,89923,44143,-110
6.0,90000,8,0.25,336,45000,43805,47095,44998,1193
5.0,90000,8,0.05,336,45000,44220,90000,44220,0
12.0,90000,9,0.05,378,45000,44730,90000,44730,0
3.0,90000,8,0.15,336,45000,42214,88656,42066,-148
14.0,90000,8,0.225,336,45000,44156,45103,45000,844
13.0,90000,9,0.05,378,45000,44528,90000,44528,0
15.0,90000,8,0.225,336,45000,44185,45052,45000,815
10.0,90000,9,0.05,378,45000,44346,90000,44346,0
11.0,90000,9,0.125,378,45000,44253,88878,44307,54
6.0,90000,9,0.025,378,45000,44051,90000,44051,0
5.0,90000,8,0.075,336,45000,44220,90000,44220,0
12.0,90000,9,0.075,378,45000,44730,90000,44730,0
14.0,90000,8,0.25,336,45000,44156,45000,45000,844
13.0,90000,9,0.075,378,45000,44528,90000,44528,0
15.0,90000,8,0.25,336,45000,44185,45000,45000,815
1.0,90000,1,0.175,42,45174,45146,87011,42333,-2813
10.0,90000,9,0.075,378,45000,44346,90000,44346,0
11.0,90000,9,0.15,378,45000,44253,81547,45000,747
2.0,90000,5,0.25,210,45001,42789,65992,44980,2191
6.0,90000,9,0.05,378,45000,44051,90000,44051,0
3.0,90000,8,0.175,336,45000,42214,84988,44451,2237
5.0,90000,8,0.1,336,45000,44220,89981,44179,-41
12.0,90000,9,0.1,378,45000,44730,89934,44664,-66
14.0,90000,9,0.025,378,45000,44815,90000,44815,0
13.0,90000,9,0.1,378,45000,44528,89912,44441,-87
15.0,90000,9,0.025,378,45000,44802,90000,44802,0
10.0,90000,9,0.1,378,45000,44346,89945,44227,-119
11.0,90000,9,0.175,378,45000,44253,65206,45000,747
6.0,90000,9,0.075,378,45000,44051,90000,44051,0
12.0,90000,9,0.125,378,45000,44730,88646,44665,-65
5.0,90000,8,0.125,336,45000,44220,89689,43619,-601
14.0,90000,9,0.05,378,45000,44815,90000,44815,0
13.0,90000,9,0.125,378,45000,44528,88331,44670,142
15.0,90000,9,0.05,378,45000,44802,90000,44802,0
10.0,90000,9,0.125,378,45000,44346,89121,44140,-206
11.0,90000,9,0.2,378,45000,44253,50655,45000,747
1.0,90000,1,0.2,42,45174,45146,82968,38714,-6432
3.0,90000,8,0.2,336,45000,42214,77945,44988,2774
2.0,90000,6,0.025,252,45001,42987,90000,42987,0
6.0,90000,9,0.1,378,45000,44051,89975,44012,-39
12.0,90000,9,0.15,378,45000,44730,79966,45000,270
5.0,90000,8,0.15,336,45000,44220,87574,44228,8
14.0,90000,9,0.075,378,45000,44815,90000,44815,0
13.0,90000,9,0.15,378,45000,44528,78164,45000,472
15.0,90000,9,0.075,378,45000,44802,89999,44801,-1
11.0,90000,9,0.225,378,45000,44253,45707,45000,747
10.0,90000,9,0.15,378,45000,44346,83066,44975,629
6.0,90000,9,0.125,378,45000,44051,89608,43079,-972
12.0,90000,9,0.175,378,45000,44730,61941,45000,270
5.0,90000,8,0.175,336,45000,44220,81395,44946,726
14.0,90000,9,0.1,378,45000,44815,89895,44710,-105
13.0,90000,9,0.175,378,45000,44528,59214,45000,472
15.0,90000,9,0.1,378,45000,44802,89888,44638,-164
3.0,90000,8,0.225,336,45000,42214,67896,44995,2781
11.0,90000,9,0.25,378,45000,44253,45058,45000,747
2.0,90000,6,0.05,252,45001,42987,90000,42987,0
10.0,90000,9,0.175,378,45000,44346,67706,45000,654
6.0,90000,9,0.15,378,45000,44051,87369,44553,502
12.0,90000,9,0.2,378,45000,44730,49048,45000,270
1.0,90000,1,0.225,42,45174,45146,78219,45053,-93
5.0,90000,8,0.2,336,45000,44220,69778,44998,778
14.0,90000,9,0.125,378,45000,44815,87936,44825,10
13.0,90000,9,0.2,378,45000,44528,47763,45000,472
15.0,90000,9,0.125,378,45000,44802,87610,44854,52
10.0,90000,9,0.2,378,45000,44346,52858,45000,654
6.0,90000,9,0.175,378,45000,44051,79300,45000,949
12.0,90000,9,0.225,378,45000,44730,45398,45000,270
13.0,90000,9,0.225,378,45000,44528,45235,45000,472
14.0,90000,9,0.15,378,45000,44815,76109,45000,185
5.0,90000,8,0.225,336,45000,44220,57310,44999,779
3.0,90000,8,0.25,336,45000,42214,57291,44985,2771
15.0,90000,9,0.15,378,45000,44802,74203,45000,198
10.0,90000,9,0.225,378,45000,44346,46286,45000,654
6.0,90000,9,0.2,378,45000,44051,66056,45000,949
12.0,90000,9,0.25,378,45000,44730,45026,45000,270
13.0,90000,9,0.25,378,45000,44528,45017,45000,472
5.0,90000,8,0.25,336,45000,44220,49526,44996,776
14.0,90000,9,0.175,378,45000,44815,57120,45000,185
2.0,90000,6,0.075,252,45001,42987,89998,42973,-14
15.0,90000,9,0.175,378,45000,44802,54944,45000,198
10.0,90000,9,0.25,378,45000,44346,45121,45000,654
6.0,90000,9,0.225,378,45000,44051,53812,45000,949
1.0,90000,1,0.25,42,45174,45146,72070,44968,-178
14.0,90000,9,0.2,378,45000,44815,46912,45000,185
5.0,90000,9,0.025,378,45000,44426,90000,44426,0
15.0,90000,9,0.2,378,45000,44802,46304,45000,198
3.0,90000,9,0.025,378,45000,42792,90000,42792,0
6.0,90000,9,0.25,378,45000,44051,47309,44999,948
14.0,90000,9,0.225,378,45000,44815,45125,45000,185
5.0,90000,9,0.05,378,45000,44426,90000,44426,0
15.0,90000,9,0.225,378,45000,44802,45060,45000,198
2.0,90000,6,0.1,252,45001,42987,89967,42902,-85
14.0,90000,9,0.25,378,45000,44815,45006,45000,185
5.0,90000,9,0.075,378,45000,44426,90000,44426,0
15.0,90000,9,0.25,378,45000,44802,45002,45000,198
3.0,90000,9,0.05,378,45000,42792,90000,42792,0
1.0,90000,2,0.025,84,45156,45156,89999,45156,0
5.0,90000,9,0.1,378,45000,44426,89976,44402,-24
5.0,90000,9,0.125,378,45000,44426,89715,44051,-375
2.0,90000,6,0.125,252,45001,42987,89751,42375,-612
3.0,90000,9,0.075,378,45000,42792,89997,42789,-3
5.0,90000,9,0.15,378,45000,44426,87936,44217,-209
1.0,90000,2,0.05,84,45156,45156,89995,45155,-1
5.0,90000,9,0.175,378,45000,44426,82198,44968,542
2.0,90000,6,0.15,252,45001,42987,88856,42733,-254
3.0,90000,9,0.1,378,45000,42792,89973,42755,-37
5.0,90000,9,0.2,378,45000,44426,70643,45000,574
5.0,90000,9,0.225,378,45000,44426,57650,45000,574
1.0,90000,2,0.075,84,45156,45156,89979,45155,-1
3.0,90000,9,0.125,378,45000,42792,89777,42085,-707
5.0,90000,9,0.25,378,45000,44426,49876,44998,572
2.0,90000,6,0.175,252,45001,42987,86803,42735,-252
3.0,90000,9,0.15,378,45000,42792,88787,41444,-1348
2.0,90000,6,0.2,252,45001,42987,81436,44715,1728
1.0,90000,2,0.1,84,45156,45156,89879,45152,-4
3.0,90000,9,0.175,378,45000,42792,85313,44538,1746
2.0,90000,6,0.225,252,45001,42987,73663,44943,1956
1.0,90000,2,0.125,84,45156,45156,89555,45147,-9
3.0,90000,9,0.2,378,45000,42792,78598,44970,2178
2.0,90000,6,0.25,252,45001,42987,65723,44960,1973
3.0,90000,9,0.225,378,45000,42792,68477,44995,2203
1.0,90000,2,0.15,84,45156,45156,88543,45129,-27
3.0,90000,9,0.25,378,45000,42792,57795,44983,2191
2.0,90000,7,0.025,294,45000,42584,90000,42584,0
1.0,90000,2,0.175,84,45156,45156,87307,45134,-22
20.0,90000,0,0.025,0,45000,44547,90000,44547,0
2.0,90000,7,0.05,294,45000,42584,90000,42584,0
30.0,90000,0,0.025,0,45000,44531,90000,44531,0
1.0,90000,2,0.2,84,45156,45156,83483,45089,-67
20.0,90000,0,0.05,0,45000,44547,90000,44547,0
2.0,90000,7,0.075,294,45000,42584,89996,42581,-3
20.0,90000,0,0.075,0,45000,44547,89998,44545,-2
1.0,90000,2,0.225,84,45156,45156,78846,45028,-128
2.0,90000,7,0.1,294,45000,42584,89960,42535,-49
20.0,90000,0,0.1,0,45000,44547,89670,44253,-294
2.0,90000,7,0.125,294,45000,42584,89727,41930,-654
1.0,90000,2,0.25,84,45156,45156,72728,44949,-207
20.0,90000,0,0.125,0,45000,44547,83324,45000,453
2.0,90000,7,0.15,294,45000,42584,88751,42673,89
20.0,90000,0,0.15,0,45000,44547,61941,45000,453
1.0,90000,3,0.025,126,45171,45171,90000,45171,0
20.0,90000,0,0.175,0,45000,44547,47317,45000,453
2.0,90000,7,0.175,294,45000,42584,86519,42689,105
20.0,90000,0,0.2,0,45000,44547,45082,45000,453
1.0,90000,3,0.05,126,45171,45171,89997,45171,0
2.0,90000,7,0.2,294,45000,42584,81046,44692,2108
20.0,90000,0,0.225,0,45000,44547,45000,45000,453
2.0,90000,7,0.225,294,45000,42584,73497,44950,2366
1.0,90000,3,0.075,126,45171,45171,89976,45170,-1
20.0,90000,0,0.25,0,45000,44547,45000,45000,453
20.0,90000,1,0.025,42,45000,44633,90000,44633,0
2.0,90000,7,0.25,294,45000,42584,65643,44971,2387
1.0,90000,3,0.1,126,45171,45171,89880,45168,-3
20.0,90000,1,0.05,42,45000,44633,90000,44633,0
2.0,90000,8,0.025,336,45000,42200,90000,42200,0
20.0,90000,1,0.075,42,45000,44633,89999,44482,-151
1.0,90000,3,0.125,126,45171,45171,89506,45164,-7
2.0,90000,8,0.05,336,45000,42200,90000,42200,0
20.0,90000,1,0.1,42,45000,44633,89709,43891,-742
2.0,90000,8,0.075,336,45000,42200,89996,42196,-4
1.0,90000,3,0.15,126,45171,45171,88506,45146,-25
20.0,90000,1,0.125,42,45000,44633,83751,45000,367
2.0,90000,8,0.1,336,45000,42200,89950,42081,-119
20.0,90000,1,0.15,42,45000,44633,62730,45000,367
1.0,90000,3,0.175,126,45171,45171,87221,45144,-27
20.0,90000,1,0.175,42,45000,44633,47602,45000,367
2.0,90000,8,0.125,336,45000,42200,89700,41157,-1043
1.0,90000,3,0.2,126,45171,45171,83376,45105,-66
20.0,90000,1,0.2,42,45000,44633,45116,45000,367
2.0,90000,8,0.15,336,45000,42200,88715,42659,459
20.0,90000,1,0.225,42,45000,44633,45002,45000,367
1.0,90000,3,0.225,126,45171,45171,78638,45042,-129
2.0,90000,8,0.175,336,45000,42200,86580,42699,499
20.0,90000,1,0.25,42,45000,44633,45000,45000,367
2.0,90000,8,0.2,336,45000,42200,81065,44650,2450
20.0,90000,2,0.025,84,45000,44850,90000,44850,0
1.0,90000,3,0.25,126,45171,45171,72725,44956,-215
20.0,90000,2,0.05,84,45000,44850,90000,44850,0
2.0,90000,8,0.225,336,45000,42200,73400,44942,2742
1.0,90000,4,0.025,168,45151,45139,89998,45138,-1
20.0,90000,2,0.075,84,45000,44850,89999,44849,-1
2.0,90000,8,0.25,336,45000,42200,65451,44961,2761
20.0,90000,2,0.1,84,45000,44850,89742,44443,-407
1.0,90000,4,0.05,168,45151,45139,89994,45136,-3
2.0,90000,9,0.025,378,45000,42493,90000,42493,0
20.0,90000,2,0.125,84,45000,44850,84342,45000,150
2.0,90000,9,0.05,378,45000,42493,90000,42493,0
1.0,90000,4,0.075,168,45151,45139,89984,45125,-14
20.0,90000,2,0.15,84,45000,44850,63403,45000,150
2.0,90000,9,0.075,378,45000,42493,89995,42477,-16
20.0,90000,2,0.175,84,45000,44850,47621,45000,150
1.0,90000,4,0.1,168,45151,45139,89884,45028,-111
20.0,90000,2,0.2,84,45000,44850,45105,45000,150
2.0,90000,9,0.1,378,45000,42493,89956,42385,-108
20.0,90000,2,0.225,84,45000,44850,45002,45000,150
1.0,90000,4,0.125,168,45151,45139,89567,44735,-404
2.0,90000,9,0.125,378,45000,42493,89758,41782,-711
20.0,90000,2,0.25,84,45000,44850,45000,45000,150
