Coefficient,Nodes,Trial,Epsilon,Seed,GroundTruth_MIS,Greedy_MIS,Size_S,Oracle_MIS,Improvement
1.0,85000,0,0.025,0,42665,42665,85000,42665,0
2.0,85000,0,0.025,0,42503,40372,85000,40372,0
1.0,85000,0,0.05,0,42665,42665,84999,42665,0
2.0,85000,0,0.05,0,42503,40372,85000,40372,0
1.0,85000,0,0.075,0,42665,42665,84984,42665,0
2.0,85000,0,0.075,0,42503,40372,84995,40367,-5
2.0,85000,0,0.075,0,42503,40372,84995,40367,-5
5.0,85000,0,0.025,0,42500,42072,85000,42072,0
4.0,85000,0,0.025,0,42500,41270,85000,41270,0
2.0,85000,0,0.1,0,42503,40372,84959,40258,-114
6.0,85000,0,0.025,0,42500,41702,85000,41702,0
1.0,85000,0,0.1,0,42665,42665,84896,42661,-4
2.0,85000,0,0.1,0,42503,40372,84959,40258,-114
7.0,85000,0,0.025,0,42500,41479,85000,41479,0
5.0,85000,0,0.05,0,42500,42072,85000,42072,0
8.0,85000,0,0.025,0,42500,41263,85000,41263,0
6.0,85000,0,0.05,0,42500,41702,85000,41702,0
2.0,85000,0,0.125,0,42503,40372,84757,39689,-683
4.0,85000,0,0.05,0,42500,41270,85000,41270,0
9.0,85000,0,0.025,0,42500,41536,85000,41536,0
5.0,85000,0,0.075,0,42500,42072,85000,42072,0
7.0,85000,0,0.05,0,42500,41479,85000,41479,0
2.0,85000,0,0.125,0,42503,40372,84757,39689,-683
8.0,85000,0,0.05,0,42500,41263,85000,41263,0
1.0,85000,0,0.125,0,42665,42665,84587,42659,-6
9.0,85000,0,0.05,0,42500,41536,85000,41536,0
6.0,85000,0,0.075,0,42500,41702,84999,41701,-1
5.0,85000,0,0.1,0,42500,42072,84974,42034,-38
2.0,85000,0,0.15,0,42503,40372,83839,39991,-381
10.0,85000,0,0.025,0,42500,41915,85000,41915,0
15.0,85000,0,0.025,0,42500,41059,85000,41059,0
11.0,85000,0,0.025,0,42500,41795,85000,41795,0
12.0,85000,0,0.025,0,42500,42184,85000,42184,0
13.0,85000,0,0.025,0,42500,41851,85000,41851,0
14.0,85000,0,0.025,0,42500,41540,85000,41540,0
8.0,85000,0,0.075,0,42500,41263,85000,41263,0
7.0,85000,0,0.075,0,42500,41479,85000,41479,0
4.0,85000,0,0.075,0,42500,41270,84999,41260,-10
2.0,85000,0,0.15,0,42503,40372,83839,39991,-381
9.0,85000,0,0.075,0,42500,41536,85000,41536,0
5.0,85000,0,0.125,0,42500,42072,84684,41650,-422
15.0,85000,0,0.05,0,42500,41059,85000,41059,0
10.0,85000,0,0.05,0,42500,41915,85000,41915,0
11.0,85000,0,0.05,0,42500,41795,85000,41795,0
12.0,85000,0,0.05,0,42500,42184,85000,42184,0
13.0,85000,0,0.05,0,42500,41851,85000,41851,0
14.0,85000,0,0.05,0,42500,41540,85000,41540,0
8.0,85000,0,0.1,0,42500,41263,84983,41246,-17
6.0,85000,0,0.1,0,42500,41702,84978,41664,-38
2.0,85000,0,0.175,0,42503,40372,81893,40053,-319
1.0,85000,0,0.15,0,42665,42665,83571,42646,-19
9.0,85000,0,0.1,0,42500,41536,84969,41505,-31
7.0,85000,0,0.1,0,42500,41479,84979,41439,-40
15.0,85000,0,0.075,0,42500,41059,85000,41059,0
10.0,85000,0,0.075,0,42500,41915,85000,41915,0
11.0,85000,0,0.075,0,42500,41795,85000,41795,0
5.0,85000,0,0.15,0,42500,42072,82859,41832,-240
12.0,85000,0,0.075,0,42500,42184,85000,42184,0
13.0,85000,0,0.075,0,42500,41851,85000,41851,0
14.0,85000,0,0.075,0,42500,41540,84999,41539,-1
8.0,85000,0,0.125,0,42500,41263,84382,41181,-82
2.0,85000,0,0.175,0,42503,40372,81893,40053,-319
4.0,85000,0,0.1,0,42500,41270,84980,41241,-29
9.0,85000,0,0.125,0,42500,41536,84261,41514,-22
6.0,85000,0,0.125,0,42500,41702,84623,41061,-641
10.0,85000,0,0.1,0,42500,41915,84963,41878,-37
15.0,85000,0,0.1,0,42500,41059,84885,42080,1021
11.0,85000,0,0.1,0,42500,41795,84957,41716,-79
12.0,85000,0,0.1,0,42500,42184,84943,42087,-97
14.0,85000,0,0.1,0,42500,41540,84918,40629,-911
13.0,85000,0,0.1,0,42500,41851,84929,41781,-70
5.0,85000,0,0.175,0,42500,42072,77287,42500,428
2.0,85000,0,0.2,0,42503,40372,76786,42175,1803
8.0,85000,0,0.15,0,42500,41263,80340,42500,1237
7.0,85000,0,0.125,0,42500,41479,84542,41614,135
9.0,85000,0,0.15,0,42500,41536,79262,42500,964
1.0,85000,0,0.175,0,42665,42665,82371,42637,-28
2.0,85000,0,0.2,0,42503,40372,76786,42175,1803
10.0,85000,0,0.125,0,42500,41915,84067,41494,-421
15.0,85000,0,0.125,0,42500,41059,82485,42500,1441
12.0,85000,0,0.125,0,42500,42184,83609,42229,45
11.0,85000,0,0.125,0,42500,41795,83827,42225,430
13.0,85000,0,0.125,0,42500,41851,83266,42457,606
14.0,85000,0,0.125,0,42500,41540,82894,42454,914
5.0,85000,0,0.2,0,42500,42072,65815,42500,428
8.0,85000,0,0.175,0,42500,41263,69536,42500,1237
6.0,85000,0,0.15,0,42500,41702,82182,42144,442
4.0,85000,0,0.125,0,42500,41270,84737,40872,-398
9.0,85000,0,0.175,0,42500,41536,66153,42500,964
2.0,85000,0,0.225,0,42503,40372,69665,42457,2085
7.0,85000,0,0.15,0,42500,41479,81316,42430,951
10.0,85000,0,0.15,0,42500,41915,77876,42500,585
15.0,85000,0,0.15,0,42500,41059,69023,42500,1441
12.0,85000,0,0.15,0,42500,42184,74756,42500,316
11.0,85000,0,0.15,0,42500,41795,76422,42500,705
13.0,85000,0,0.15,0,42500,41851,72940,42500,649
14.0,85000,0,0.15,0,42500,41540,71071,42500,960
8.0,85000,0,0.2,0,42500,41263,54432,42500,1237
5.0,85000,0,0.225,0,42500,42072,54331,42500,428
2.0,85000,0,0.225,0,42503,40372,69665,42457,2085
9.0,85000,0,0.2,0,42500,41536,51784,42500,964
1.0,85000,0,0.2,0,42665,42665,78740,42594,-71
15.0,85000,0,0.175,0,42500,41059,50937,42500,1441
10.0,85000,0,0.175,0,42500,41915,63261,42500,585
12.0,85000,0,0.175,0,42500,42184,57841,42500,316
11.0,85000,0,0.175,0,42500,41795,60840,42500,705
13.0,85000,0,0.175,0,42500,41851,55115,42500,649
14.0,85000,0,0.175,0,42500,41540,52943,42500,960
6.0,85000,0,0.175,0,42500,41702,74288,42500,798
8.0,85000,0,0.225,0,42500,41263,45677,42500,1237
5.0,85000,0,0.25,0,42500,42072,46365,42495,423
2.0,85000,0,0.25,0,42503,40372,62168,42468,2096
7.0,85000,0,0.175,0,42500,41479,72313,42500,1021
4.0,85000,0,0.15,0,42500,41270,83376,41178,-92
9.0,85000,0,0.225,0,42500,41536,44457,42500,964
15.0,85000,0,0.2,0,42500,41059,43486,42500,1441
10.0,85000,0,0.2,0,42500,41915,49259,42500,585
12.0,85000,0,0.2,0,42500,42184,45912,42500,316
11.0,85000,0,0.2,0,42500,41795,47284,42500,705
14.0,85000,0,0.2,0,42500,41540,44022,42500,960
8.0,85000,0,0.25,0,42500,41263,42996,42500,1237
13.0,85000,0,0.2,0,42500,41851,44808,42500,649
5.0,85000,1,0.025,42,42500,41814,85000,41814,0
2.0,85000,0,0.25,0,42503,40372,62168,42468,2096
9.0,85000,0,0.25,0,42500,41536,42706,42499,963
6.0,85000,0,0.2,0,42500,41702,62002,42500,798
15.0,85000,0,0.225,0,42500,41059,42544,42500,1441
10.0,85000,0,0.225,0,42500,41915,43648,42500,585
7.0,85000,0,0.2,0,42500,41479,58352,42500,1021
12.0,85000,0,0.225,0,42500,42184,42842,42500,316
11.0,85000,0,0.225,0,42500,41795,43133,42500,705
13.0,85000,0,0.225,0,42500,41851,42678,42500,649
14.0,85000,0,0.225,0,42500,41540,42579,42500,960
1.0,85000,0,0.225,0,42665,42665,74307,42548,-117
2.0,85000,1,0.025,42,42501,39701,85000,39701,0
8.0,85000,1,0.025,42,42500,41528,85000,41528,0
5.0,85000,1,0.05,42,42500,41814,85000,41814,0
9.0,85000,1,0.025,42,42500,40486,85000,40486,0
4.0,85000,0,0.175,0,42500,41270,79369,42391,1121
15.0,85000,0,0.25,0,42500,41059,42501,42500,1441
10.0,85000,0,0.25,0,42500,41915,42581,42498,583
12.0,85000,0,0.25,0,42500,42184,42513,42500,316
11.0,85000,0,0.25,0,42500,41795,42536,42500,705
13.0,85000,0,0.25,0,42500,41851,42510,42500,649
14.0,85000,0,0.25,0,42500,41540,42502,42500,960
2.0,85000,1,0.025,42,42501,39701,85000,39701,0
8.0,85000,1,0.05,42,42500,41528,85000,41528,0
6.0,85000,0,0.225,0,42500,41702,50444,42499,797
7.0,85000,0,0.225,0,42500,41479,47600,42500,1021
5.0,85000,1,0.075,42,42500,41814,84999,41813,-1
9.0,85000,1,0.05,42,42500,40486,85000,40486,0
2.0,85000,1,0.05,42,42501,39701,85000,39701,0
15.0,85000,1,0.025,42,42500,41722,85000,41722,0
10.0,85000,1,0.025,42,42500,41967,85000,41967,0
12.0,85000,1,0.025,42,42500,41953,85000,41953,0
11.0,85000,1,0.025,42,42500,40721,85000,40721,0
13.0,85000,1,0.025,42,42500,41292,85000,41292,0
14.0,85000,1,0.025,42,42500,41682,85000,41682,0
1.0,85000,0,0.25,0,42665,42665,68648,42469,-196
8.0,85000,1,0.075,42,42500,41528,85000,41528,0
9.0,85000,1,0.075,42,42500,40486,85000,40486,0
5.0,85000,1,0.1,42,42500,41814,84988,41791,-23
6.0,85000,0,0.25,0,42500,41702,44531,42498,796
2.0,85000,1,0.05,42,42501,39701,85000,39701,0
7.0,85000,0,0.25,0,42500,41479,43551,42500,1021
4.0,85000,0,0.2,0,42500,41270,69716,42499,1229
10.0,85000,1,0.05,42,42500,41967,85000,41967,0
15.0,85000,1,0.05,42,42500,41722,85000,41722,0
12.0,85000,1,0.05,42,42500,41953,85000,41953,0
11.0,85000,1,0.05,42,42500,40721,85000,40721,0
13.0,85000,1,0.05,42,42500,41292,85000,41292,0
14.0,85000,1,0.05,42,42500,41682,85000,41682,0
8.0,85000,1,0.1,42,42500,41528,84978,41528,0
2.0,85000,1,0.075,42,42501,39701,84996,39701,0
9.0,85000,1,0.1,42,42500,40486,84973,40376,-110
5.0,85000,1,0.125,42,42500,41814,84726,41417,-397
11.0,85000,1,0.075,42,42500,40721,85000,40721,0
10.0,85000,1,0.075,42,42500,41967,85000,41967,0
12.0,85000,1,0.075,42,42500,41953,85000,41953,0
15.0,85000,1,0.075,42,42500,41722,84998,41720,-2
13.0,85000,1,0.075,42,42500,41292,84999,41292,0
14.0,85000,1,0.075,42,42500,41682,84999,41681,-1
6.0,85000,1,0.025,42,42500,41799,85000,41799,0
8.0,85000,1,0.125,42,42500,41528,84493,41528,0
7.0,85000,1,0.025,42,42500,41456,85000,41456,0
1.0,85000,1,0.025,42,42670,42670,85000,42670,0
2.0,85000,1,0.075,42,42501,39701,84996,39701,0
9.0,85000,1,0.125,42,42500,40486,84330,41961,1475
5.0,85000,1,0.15,42,42500,41814,82987,41998,184
11.0,85000,1,0.1,42,42500,40721,84961,40612,-109
12.0,85000,1,0.1,42,42500,41953,84945,41780,-173
10.0,85000,1,0.1,42,42500,41967,84961,41967,0
4.0,85000,0,0.225,0,42500,41270,59058,42498,1228
15.0,85000,1,0.1,42,42500,41722,84913,41530,-192
13.0,85000,1,0.1,42,42500,41292,84935,41292,0
2.0,85000,1,0.1,42,42501,39701,84973,39682,-19
14.0,85000,1,0.1,42,42500,41682,84925,41559,-123
8.0,85000,1,0.15,42,42500,41528,80687,42422,894
9.0,85000,1,0.15,42,42500,40486,79741,42500,2014
6.0,85000,1,0.05,42,42500,41799,85000,41799,0
11.0,85000,1,0.125,42,42500,40721,83909,42362,1641
7.0,85000,1,0.05,42,42500,41456,85000,41456,0
5.0,85000,1,0.175,42,42500,41814,77416,42491,677
12.0,85000,1,0.125,42,42500,41953,83704,42461,508
10.0,85000,1,0.125,42,42500,41967,84147,42318,351
15.0,85000,1,0.125,42,42500,41722,82732,42500,778
13.0,85000,1,0.125,42,42500,41292,83425,42500,1208
14.0,85000,1,0.125,42,42500,41682,83077,42359,677
2.0,85000,1,0.1,42,42501,39701,84973,39682,-19
8.0,85000,1,0.175,42,42500,41528,69988,42500,972
9.0,85000,1,0.175,42,42500,40486,66939,42500,2014
1.0,85000,1,0.05,42,42670,42670,84998,42669,-1
2.0,85000,1,0.125,42,42501,39701,84787,39727,26
11.0,85000,1,0.15,42,42500,40721,77075,42500,1779
4.0,85000,0,0.25,0,42500,41270,49783,42491,1221
12.0,85000,1,0.15,42,42500,41953,75515,42500,547
5.0,85000,1,0.2,42,42500,41814,66804,42500,686
10.0,85000,1,0.15,42,42500,41967,78430,42500,533
15.0,85000,1,0.15,42,42500,41722,70073,42500,778
13.0,85000,1,0.15,42,42500,41292,73871,42500,1208
14.0,85000,1,0.15,42,42500,41682,71999,42500,818
6.0,85000,1,0.075,42,42500,41799,85000,41799,0
7.0,85000,1,0.075,42,42500,41456,85000,41456,0
8.0,85000,1,0.2,42,42500,41528,55486,42500,972
9.0,85000,1,0.2,42,42500,40486,52406,42500,2014
11.0,85000,1,0.175,42,42500,40721,61251,42500,1779
12.0,85000,1,0.175,42,42500,41953,58369,42500,547
10.0,85000,1,0.175,42,42500,41967,63710,42500,533
15.0,85000,1,0.175,42,42500,41722,51482,42500,778
2.0,85000,1,0.125,42,42501,39701,84787,39727,26
5.0,85000,1,0.225,42,42500,41814,54512,42499,685
13.0,85000,1,0.175,42,42500,41292,55688,42500,1208
14.0,85000,1,0.175,42,42500,41682,53543,42500,818
8.0,85000,1,0.225,42,42500,41528,45995,42500,972
2.0,85000,1,0.15,42,42501,39701,83896,42175,2474
9.0,85000,1,0.225,42,42500,40486,44629,42500,2014
11.0,85000,1,0.2,42,42500,40721,47831,42500,1779
12.0,85000,1,0.2,42,42500,41953,46264,42500,547
7.0,85000,1,0.1,42,42500,41456,84971,41430,-26
10.0,85000,1,0.2,42,42500,41967,49809,42500,533
15.0,85000,1,0.2,42,42500,41722,43674,42500,778
6.0,85000,1,0.1,42,42500,41799,84975,41759,-40
1.0,85000,1,0.075,42,42670,42670,84975,42669,-1
13.0,85000,1,0.2,42,42500,41292,45122,42500,1208
4.0,85000,1,0.025,42,42500,40806,85000,40806,0
5.0,85000,1,0.25,42,42500,41814,47108,42498,684
14.0,85000,1,0.2,42,42500,41682,44302,42500,818
8.0,85000,1,0.25,42,42500,41528,42995,42499,971
9.0,85000,1,0.25,42,42500,40486,42715,42500,2014
11.0,85000,1,0.225,42,42500,40721,43189,42500,1779
12.0,85000,1,0.225,42,42500,41953,42863,42500,547
2.0,85000,1,0.15,42,42501,39701,83896,42175,2474
15.0,85000,1,0.225,42,42500,41722,42556,42500,778
10.0,85000,1,0.225,42,42500,41967,43764,42500,533
13.0,85000,1,0.225,42,42500,41292,42700,42500,1208
5.0,85000,2,0.025,84,42500,41794,85000,41794,0
14.0,85000,1,0.225,42,42500,41682,42617,42500,818
2.0,85000,1,0.175,42,42501,39701,81957,42178,2477
7.0,85000,1,0.125,42,42500,41456,84571,41439,-17
8.0,85000,2,0.025,84,42500,42075,85000,42075,0
6.0,85000,1,0.125,42,42500,41799,84640,40844,-955
9.0,85000,2,0.025,84,42500,41131,85000,41131,0
11.0,85000,1,0.25,42,42500,40721,42539,42500,1779
12.0,85000,1,0.25,42,42500,41953,42512,42500,547
15.0,85000,1,0.25,42,42500,41722,42499,42499,777
10.0,85000,1,0.25,42,42500,41967,42589,42499,532
13.0,85000,1,0.25,42,42500,41292,42506,42500,1208
14.0,85000,1,0.25,42,42500,41682,42501,42500,818
4.0,85000,1,0.05,42,42500,40806,85000,40806,0
1.0,85000,1,0.1,42,42670,42670,84899,42665,-5
5.0,85000,2,0.05,84,42500,41794,85000,41794,0
8.0,85000,2,0.05,84,42500,42075,85000,42075,0
9.0,85000,2,0.05,84,42500,41131,85000,41131,0
2.0,85000,1,0.175,42,42501,39701,81957,42178,2477
11.0,85000,2,0.025,84,42500,41245,85000,41245,0
12.0,85000,2,0.025,84,42500,41888,85000,41888,0
10.0,85000,2,0.025,84,42500,40491,85000,40491,0
15.0,85000,2,0.025,84,42500,41286,85000,41286,0
13.0,85000,2,0.025,84,42500,41581,85000,41581,0
7.0,85000,1,0.15,42,42500,41456,81592,42326,870
2.0,85000,1,0.2,42,42501,39701,76962,42448,2747
6.0,85000,1,0.15,42,42500,41799,82517,42180,381
14.0,85000,2,0.025,84,42500,42125,85000,42125,0
5.0,85000,2,0.075,84,42500,41794,84998,41793,-1
9.0,85000,2,0.075,84,42500,41131,85000,41131,0
8.0,85000,2,0.075,84,42500,42075,84999,42074,-1
11.0,85000,2,0.05,84,42500,41245,85000,41245,0
10.0,85000,2,0.05,84,42500,40491,85000,40491,0
12.0,85000,2,0.05,84,42500,41888,85000,41888,0
15.0,85000,2,0.05,84,42500,41286,85000,41286,0
13.0,85000,2,0.05,84,42500,41581,85000,41581,0
4.0,85000,1,0.075,42,42500,40806,84999,40806,0
14.0,85000,2,0.05,84,42500,42125,85000,42125,0
2.0,85000,1,0.2,42,42501,39701,76962,42448,2747
5.0,85000,2,0.1,84,42500,41794,84980,41763,-31
1.0,85000,1,0.125,42,42670,42670,84614,42660,-10
7.0,85000,1,0.175,42,42500,41456,72705,42500,1044
9.0,85000,2,0.1,84,42500,41131,84968,41131,0
11.0,85000,2,0.075,84,42500,41245,85000,41245,0
6.0,85000,1,0.175,42,42500,41799,74675,42500,701
8.0,85000,2,0.1,84,42500,42075,84972,42047,-28
10.0,85000,2,0.075,84,42500,40491,85000,40491,0
2.0,85000,1,0.225,42,42501,39701,69848,42477,2776
12.0,85000,2,0.075,84,42500,41888,84999,41887,-1
15.0,85000,2,0.075,84,42500,41286,84998,41286,0
13.0,85000,2,0.075,84,42500,41581,85000,41581,0
14.0,85000,2,0.075,84,42500,42125,84999,42125,0
5.0,85000,2,0.125,84,42500,41794,84727,41455,-339
11.0,85000,2,0.1,84,42500,41245,84951,41162,-83
9.0,85000,2,0.125,84,42500,41131,84409,41159,28
10.0,85000,2,0.1,84,42500,40491,84965,40361,-130
8.0,85000,2,0.125,84,42500,42075,84505,41131,-944
12.0,85000,2,0.1,84,42500,41888,84948,41838,-50
15.0,85000,2,0.1,84,42500,41286,84916,41286,0
13.0,85000,2,0.1,84,42500,41581,84938,41581,0
7.0,85000,1,0.2,42,42500,41456,58932,42500,1044
2.0,85000,1,0.225,42,42501,39701,69848,42477,2776
6.0,85000,1,0.2,42,42500,41799,62572,42500,701
4.0,85000,1,0.1,42,42500,40806,84984,40792,-14
14.0,85000,2,0.1,84,42500,42125,84929,42125,0
2.0,85000,1,0.25,42,42501,39701,62424,42453,2752
5.0,85000,2,0.15,84,42500,41794,83195,41861,67
11.0,85000,2,0.125,84,42500,41245,84039,42265,1020
9.0,85000,2,0.15,84,42500,41131,80065,42500,1369
10.0,85000,2,0.125,84,42500,40491,84255,41695,1204
1.0,85000,1,0.15,42,42670,42670,83705,42647,-23
12.0,85000,2,0.125,84,42500,41888,83814,42351,463
8.0,85000,2,0.15,84,42500,42075,80993,42461,386
15.0,85000,2,0.125,84,42500,41286,82836,42403,1117
13.0,85000,2,0.125,84,42500,41581,83535,42339,758
14.0,85000,2,0.125,84,42500,42125,83213,42415,290
7.0,85000,1,0.225,42,42500,41456,48059,42500,1044
11.0,85000,2,0.15,84,42500,41245,77539,42500,1255
10.0,85000,2,0.15,84,42500,40491,78811,42500,2009
9.0,85000,2,0.175,84,42500,41131,67187,42500,1369
5.0,85000,2,0.175,84,42500,41794,77788,42491,697
6.0,85000,1,0.225,42,42500,41799,50860,42500,701
12.0,85000,2,0.15,84,42500,41888,76003,42500,612
2.0,85000,1,0.25,42,42501,39701,62424,42453,2752
8.0,85000,2,0.175,84,42500,42075,70483,42500,425
15.0,85000,2,0.15,84,42500,41286,70885,42500,1214
13.0,85000,2,0.15,84,42500,41581,74380,42500,919
2.0,85000,2,0.025,84,42501,39851,85000,39851,0
14.0,85000,2,0.15,84,42500,42125,72558,42500,375
4.0,85000,1,0.125,42,42500,40806,84771,40331,-475
11.0,85000,2,0.175,84,42500,41245,61856,42500,1255
10.0,85000,2,0.175,84,42500,40491,64298,42500,2009
9.0,85000,2,0.2,84,42500,41131,52429,42500,1369
5.0,85000,2,0.2,84,42500,41794,66456,42499,705
12.0,85000,2,0.175,84,42500,41888,58918,42500,612
8.0,85000,2,0.2,84,42500,42075,55206,42500,425
1.0,85000,1,0.175,42,42670,42670,82479,42635,-35
7.0,85000,1,0.25,42,42500,41456,43675,42500,1044
13.0,85000,2,0.175,84,42500,41581,56174,42500,919
15.0,85000,2,0.175,84,42500,41286,51837,42500,1214
6.0,85000,1,0.25,42,42500,41799,44667,42498,699
14.0,85000,2,0.175,84,42500,42125,53924,42500,375
2.0,85000,2,0.025,84,42501,39851,85000,39851,0
11.0,85000,2,0.2,84,42500,41245,47853,42500,1255
10.0,85000,2,0.2,84,42500,40491,49716,42500,2009
9.0,85000,2,0.225,84,42500,41131,44627,42500,1369
2.0,85000,2,0.05,84,42501,39851,84999,39847,-4
12.0,85000,2,0.2,84,42500,41888,46346,42500,612
5.0,85000,2,0.225,84,42500,41794,54711,42500,706
8.0,85000,2,0.225,84,42500,42075,46011,42500,425
13.0,85000,2,0.2,84,42500,41581,45082,42500,919
15.0,85000,2,0.2,84,42500,41286,43686,42500,1214
14.0,85000,2,0.2,84,42500,42125,44286,42500,375
7.0,85000,2,0.025,84,42500,41263,85000,41263,0
11.0,85000,2,0.225,84,42500,41245,43196,42500,1255
10.0,85000,2,0.225,84,42500,40491,43749,42500,2009
9.0,85000,2,0.25,84,42500,41131,42735,42498,1367
12.0,85000,2,0.225,84,42500,41888,42892,42500,612
6.0,85000,2,0.025,84,42500,41231,85000,41231,0
5.0,85000,2,0.25,84,42500,41794,46653,42494,700
8.0,85000,2,0.25,84,42500,42075,43029,42499,424
15.0,85000,2,0.225,84,42500,41286,42545,42500,1214
13.0,85000,2,0.225,84,42500,41581,42702,42500,919
4.0,85000,1,0.15,42,42500,40806,83397,41345,539
1.0,85000,1,0.2,42,42670,42670,78903,42597,-73
2.0,85000,2,0.05,84,42501,39851,84999,39847,-4
2.0,85000,2,0.075,84,42501,39851,84995,39834,-17
14.0,85000,2,0.225,84,42500,42125,42595,42500,375
10.0,85000,2,0.25,84,42500,40491,42603,42499,2008
11.0,85000,2,0.25,84,42500,41245,42544,42500,1255
9.0,85000,3,0.025,126,42500,41417,85000,41417,0
12.0,85000,2,0.25,84,42500,41888,42520,42500,612
15.0,85000,2,0.25,84,42500,41286,42500,42500,1214
13.0,85000,2,0.25,84,42500,41581,42507,42500,919
8.0,85000,3,0.025,126,42500,41105,85000,41105,0
5.0,85000,3,0.025,126,42500,41989,85000,41989,0
7.0,85000,2,0.05,84,42500,41263,85000,41263,0
6.0,85000,2,0.05,84,42500,41231,85000,41231,0
14.0,85000,2,0.25,84,42500,42125,42502,42499,374
10.0,85000,3,0.025,126,42500,41297,85000,41297,0
11.0,85000,3,0.025,126,42500,41672,85000,41672,0
9.0,85000,3,0.05,126,42500,41417,85000,41417,0
12.0,85000,3,0.025,126,42500,41740,85000,41740,0
15.0,85000,3,0.025,126,42500,41628,85000,41628,0
13.0,85000,3,0.025,126,42500,41571,85000,41571,0
8.0,85000,3,0.05,126,42500,41105,85000,41105,0
2.0,85000,2,0.075,84,42501,39851,84995,39834,-17
2.0,85000,2,0.1,84,42501,39851,84956,39688,-163
5.0,85000,3,0.05,126,42500,41989,85000,41989,0
1.0,85000,1,0.225,42,42670,42670,74552,42542,-128
14.0,85000,3,0.025,126,42500,41859,85000,41859,0
10.0,85000,3,0.05,126,42500,41297,85000,41297,0
11.0,85000,3,0.05,126,42500,41672,85000,41672,0
7.0,85000,2,0.075,84,42500,41263,84999,41262,-1
9.0,85000,3,0.075,126,42500,41417,84999,41417,0
12.0,85000,3,0.05,126,42500,41740,85000,41740,0
4.0,85000,1,0.175,42,42500,40806,79417,42425,1619
6.0,85000,2,0.075,84,42500,41231,84999,41230,-1
15.0,85000,3,0.05,126,42500,41628,85000,41628,0
13.0,85000,3,0.05,126,42500,41571,85000,41571,0
8.0,85000,3,0.075,126,42500,41105,85000,41105,0
5.0,85000,3,0.075,126,42500,41989,85000,41989,0
14.0,85000,3,0.05,126,42500,41859,85000,41859,0
10.0,85000,3,0.075,126,42500,41297,84999,41296,-1
9.0,85000,3,0.1,126,42500,41417,84973,41417,0
2.0,85000,2,0.125,84,42501,39851,84775,39089,-762
2.0,85000,2,0.1,84,42501,39851,84956,39688,-163
12.0,85000,3,0.075,126,42500,41740,84999,41739,-1
11.0,85000,3,0.075,126,42500,41672,84999,41671,-1
15.0,85000,3,0.075,126,42500,41628,85000,41628,0
7.0,85000,2,0.1,84,42500,41263,84971,41115,-148
13.0,85000,3,0.075,126,42500,41571,84999,41570,-1
5.0,85000,3,0.1,126,42500,41989,84982,41971,-18
8.0,85000,3,0.1,126,42500,41105,84977,40938,-167
6.0,85000,2,0.1,84,42500,41231,84972,41190,-41
10.0,85000,3,0.1,126,42500,41297,84963,40974,-323
14.0,85000,3,0.075,126,42500,41859,84998,41857,-2
1.0,85000,1,0.25,42,42670,42670,68718,42441,-229
12.0,85000,3,0.1,126,42500,41740,84942,41442,-298
9.0,85000,3,0.125,126,42500,41417,84279,41417,0
15.0,85000,3,0.1,126,42500,41628,84896,41368,-260
11.0,85000,3,0.1,126,42500,41672,84956,41593,-79
2.0,85000,2,0.15,84,42501,39851,83929,39665,-186
13.0,85000,3,0.1,126,42500,41571,84935,41509,-62
5.0,85000,3,0.125,126,42500,41989,84723,41608,-381
2.0,85000,2,0.15,84,42501,39851,83929,39665,-186
4.0,85000,1,0.2,42,42500,40806,70730,42499,1693
10.0,85000,3,0.125,126,42500,41297,84121,41451,154
14.0,85000,3,0.1,126,42500,41859,84928,41789,-70
8.0,85000,3,0.125,126,42500,41105,84429,41418,313
7.0,85000,2,0.125,84,42500,41263,84623,40272,-991
12.0,85000,3,0.125,126,42500,41740,83639,42239,499
9.0,85000,3,0.15,126,42500,41417,79614,42456,1039
6.0,85000,2,0.125,84,42500,41231,84693,40302,-929
15.0,85000,3,0.125,126,42500,41628,82621,42353,725
11.0,85000,3,0.125,126,42500,41672,83925,42160,488
13.0,85000,3,0.125,126,42500,41571,83369,42166,595
10.0,85000,3,0.15,126,42500,41297,78341,42500,1203
5.0,85000,3,0.15,126,42500,41989,82956,41772,-217
14.0,85000,3,0.125,126,42500,41859,83020,42323,464
12.0,85000,3,0.15,126,42500,41740,75361,42500,760
9.0,85000,3,0.175,126,42500,41417,66841,42500,1083
1.0,85000,2,0.025,84,42659,42659,85000,42659,0
8.0,85000,3,0.15,126,42500,41105,80672,42419,1314
2.0,85000,2,0.175,84,42501,39851,82016,39697,-154
15.0,85000,3,0.15,126,42500,41628,69935,42500,872
2.0,85000,2,0.175,84,42501,39851,82016,39697,-154
11.0,85000,3,0.15,126,42500,41672,76838,42500,828
7.0,85000,2,0.15,84,42500,41263,81869,42360,1097
13.0,85000,3,0.15,126,42500,41571,73655,42500,929
10.0,85000,3,0.175,126,42500,41297,63914,42500,1203
6.0,85000,2,0.15,84,42500,41231,82567,42133,902
5.0,85000,3,0.175,126,42500,41989,77546,42458,469
14.0,85000,3,0.15,126,42500,41859,71762,42500,641
12.0,85000,3,0.175,126,42500,41740,58599,42500,760
9.0,85000,3,0.2,126,42500,41417,51993,42500,1083
4.0,85000,1,0.225,42,42500,40806,59457,42498,1692
15.0,85000,3,0.175,126,42500,41628,51638,42500,872
11.0,85000,3,0.175,126,42500,41672,61328,42500,828
8.0,85000,3,0.175,126,42500,41105,70032,42500,1395
10.0,85000,3,0.2,126,42500,41297,49690,42500,1203
13.0,85000,3,0.175,126,42500,41571,55886,42500,929
2.0,85000,2,0.2,84,42501,39851,76909,42202,2351
14.0,85000,3,0.175,126,42500,41859,53652,42500,641
5.0,85000,3,0.2,126,42500,41989,66357,42500,511
12.0,85000,3,0.2,126,42500,41740,46267,42500,760
7.0,85000,2,0.175,84,42500,41263,72967,42500,1237
9.0,85000,3,0.225,126,42500,41417,44509,42500,1083
2.0,85000,2,0.2,84,42501,39851,76909,42202,2351
15.0,85000,3,0.2,126,42500,41628,43645,42500,872
11.0,85000,3,0.2,126,42500,41672,47730,42500,828
1.0,85000,2,0.05,84,42659,42659,85000,42659,0
6.0,85000,2,0.175,84,42500,41231,74803,42500,1269
8.0,85000,3,0.2,126,42500,41105,55049,42500,1395
10.0,85000,3,0.225,126,42500,41297,43756,42500,1203
13.0,85000,3,0.2,126,42500,41571,45058,42500,929
14.0,85000,3,0.2,126,42500,41859,44223,42500,641
12.0,85000,3,0.225,126,42500,41740,42866,42500,760
5.0,85000,3,0.225,126,42500,41989,54552,42500,511
9.0,85000,3,0.25,126,42500,41417,42745,42500,1083
15.0,85000,3,0.225,126,42500,41628,42545,42500,872
11.0,85000,3,0.225,126,42500,41672,43182,42500,828
8.0,85000,3,0.225,126,42500,41105,45840,42499,1394
7.0,85000,2,0.2,84,42500,41263,58938,42500,1237
10.0,85000,3,0.25,126,42500,41297,42604,42500,1203
2.0,85000,2,0.225,84,42501,39851,70007,42454,2603
13.0,85000,3,0.225,126,42500,41571,42686,42500,929
4.0,85000,1,0.25,42,42500,40806,49942,42491,1685
2.0,85000,2,0.225,84,42501,39851,70007,42454,2603
12.0,85000,3,0.25,126,42500,41740,42518,42500,760
14.0,85000,3,0.225,126,42500,41859,42606,42500,641
6.0,85000,2,0.2,84,42500,41231,62601,42500,1269
5.0,85000,3,0.25,126,42500,41989,46454,42496,507
9.0,85000,4,0.025,168,42500,41580,85000,41580,0
15.0,85000,3,0.25,126,42500,41628,42500,42500,872
11.0,85000,3,0.25,126,42500,41672,42546,42500,828
8.0,85000,3,0.25,126,42500,41105,43002,42500,1395
10.0,85000,4,0.025,168,42500,41520,85000,41520,0
13.0,85000,3,0.25,126,42500,41571,42505,42500,929
1.0,85000,2,0.075,84,42659,42659,84979,42657,-2
14.0,85000,3,0.25,126,42500,41859,42506,42500,641
12.0,85000,4,0.025,168,42500,41816,85000,41816,0
7.0,85000,2,0.225,84,42500,41263,48116,42500,1237
5.0,85000,4,0.025,168,42500,41756,85000,41756,0
9.0,85000,4,0.05,168,42500,41580,85000,41580,0
2.0,85000,2,0.25,84,42501,39851,60736,42446,2595
11.0,85000,4,0.025,168,42500,41937,85000,41937,0
15.0,85000,4,0.025,168,42500,41706,85000,41706,0
6.0,85000,2,0.225,84,42500,41231,51052,42500,1269
8.0,85000,4,0.025,168,42500,41390,85000,41390,0
2.0,85000,2,0.25,84,42501,39851,60736,42446,2595
10.0,85000,4,0.05,168,42500,41520,85000,41520,0
13.0,85000,4,0.025,168,42500,41818,85000,41818,0
14.0,85000,4,0.025,168,42500,41499,85000,41499,0
12.0,85000,4,0.05,168,42500,41816,85000,41816,0
9.0,85000,4,0.075,168,42500,41580,85000,41580,0
11.0,85000,4,0.05,168,42500,41937,85000,41937,0
15.0,85000,4,0.05,168,42500,41706,85000,41706,0
5.0,85000,4,0.05,168,42500,41756,85000,41756,0
4.0,85000,2,0.025,84,42500,40886,85000,40886,0
7.0,85000,2,0.25,84,42500,41263,43721,42498,1235
8.0,85000,4,0.05,168,42500,41390,85000,41390,0
10.0,85000,4,0.075,168,42500,41520,84999,41519,-1
13.0,85000,4,0.05,168,42500,41818,85000,41818,0
6.0,85000,2,0.25,84,42500,41231,44729,42498,1267
2.0,85000,3,0.025,126,42500,40277,85000,40277,0
1.0,85000,2,0.1,84,42659,42659,84902,42658,-1
12.0,85000,4,0.075,168,42500,41816,84998,41814,-2
14.0,85000,4,0.05,168,42500,41499,85000,41499,0
2.0,85000,3,0.025,126,42500,40277,85000,40277,0
9.0,85000,4,0.1,168,42500,41580,84970,41522,-58
11.0,85000,4,0.075,168,42500,41937,84999,41937,0
15.0,85000,4,0.075,168,42500,41706,84999,41705,-1
8.0,85000,4,0.075,168,42500,41390,85000,41390,0
5.0,85000,4,0.075,168,42500,41756,84999,41755,-1
10.0,85000,4,0.1,168,42500,41520,84972,41494,-26
13.0,85000,4,0.075,168,42500,41818,84999,41817,-1
12.0,85000,4,0.1,168,42500,41816,84942,41718,-98
14.0,85000,4,0.075,168,42500,41499,84999,41499,0
7.0,85000,3,0.025,126,42500,41508,85000,41508,0
9.0,85000,4,0.125,168,42500,41580,84369,41961,381
11.0,85000,4,0.1,168,42500,41937,84959,41937,0
15.0,85000,4,0.1,168,42500,41706,84909,41618,-88
6.0,85000,3,0.025,126,42500,41886,85000,41886,0
2.0,85000,3,0.05,126,42500,40277,85000,40277,0
10.0,85000,4,0.125,168,42500,41520,84187,41779,259
8.0,85000,4,0.1,168,42500,41390,84973,41197,-193
5.0,85000,4,0.1,168,42500,41756,84967,41723,-33
13.0,85000,4,0.1,168,42500,41818,84935,41665,-153
2.0,85000,3,0.05,126,42500,40277,85000,40277,0
12.0,85000,4,0.125,168,42500,41816,83698,42235,419
14.0,85000,4,0.1,168,42500,41499,84926,41499,0
4.0,85000,2,0.05,84,42500,40886,85000,40886,0
1.0,85000,2,0.125,84,42659,42659,84611,42653,-6
11.0,85000,4,0.125,168,42500,41937,83934,42297,360
9.0,85000,4,0.15,168,42500,41580,79695,42477,897
15.0,85000,4,0.125,168,42500,41706,82756,42452,746
7.0,85000,3,0.05,126,42500,41508,85000,41508,0
10.0,85000,4,0.15,168,42500,41520,78482,42500,980
8.0,85000,4,0.125,168,42500,41390,84464,40267,-1123
13.0,85000,4,0.125,168,42500,41818,83428,42292,474
12.0,85000,4,0.15,168,42500,41816,75577,42500,684
5.0,85000,4,0.125,168,42500,41756,84728,41395,-361
14.0,85000,4,0.125,168,42500,41499,83124,42128,629
2.0,85000,3,0.075,126,42500,40277,84998,40275,-2
6.0,85000,3,0.05,126,42500,41886,85000,41886,0
11.0,85000,4,0.15,168,42500,41937,77028,42500,563
9.0,85000,4,0.175,168,42500,41580,66780,42500,920
15.0,85000,4,0.15,168,42500,41706,70110,42500,794
10.0,85000,4,0.175,168,42500,41520,63874,42500,980
2.0,85000,3,0.075,126,42500,40277,84998,40275,-2
8.0,85000,4,0.15,168,42500,41390,80760,42479,1089
13.0,85000,4,0.15,168,42500,41818,73801,42500,682
12.0,85000,4,0.175,168,42500,41816,58589,42500,684
14.0,85000,4,0.15,168,42500,41499,72064,42500,1001
7.0,85000,3,0.075,126,42500,41508,85000,41508,0
5.0,85000,4,0.15,168,42500,41756,83031,41934,178
1.0,85000,2,0.15,84,42659,42659,83695,42642,-17
11.0,85000,4,0.175,168,42500,41937,61410,42500,563
9.0,85000,4,0.2,168,42500,41580,52584,42500,920
15.0,85000,4,0.175,168,42500,41706,51540,42500,794
10.0,85000,4,0.2,168,42500,41520,49964,42500,980
4.0,85000,2,0.075,84,42500,40886,84999,40885,-1
13.0,85000,4,0.175,168,42500,41818,55840,42500,682
12.0,85000,4,0.2,168,42500,41816,46435,42500,684
2.0,85000,3,0.1,126,42500,40277,84959,40211,-66
8.0,85000,4,0.175,168,42500,41390,70191,42500,1110
14.0,85000,4,0.175,168,42500,41499,53586,42500,1001
6.0,85000,3,0.075,126,42500,41886,85000,41886,0
2.0,85000,3,0.1,126,42500,40277,84959,40211,-66
5.0,85000,4,0.175,168,42500,41756,77529,42484,728
11.0,85000,4,0.2,168,42500,41937,47946,42500,563
9.0,85000,4,0.225,168,42500,41580,44755,42500,920
15.0,85000,4,0.2,168,42500,41706,43744,42500,794
10.0,85000,4,0.225,168,42500,41520,43817,42500,980
7.0,85000,3,0.1,126,42500,41508,84977,41485,-23
12.0,85000,4,0.225,168,42500,41816,42916,42500,684
13.0,85000,4,0.2,168,42500,41818,45210,42500,682
14.0,85000,4,0.2,168,42500,41499,44387,42500,1001
8.0,85000,4,0.2,168,42500,41390,55312,42500,1110
11.0,85000,4,0.225,168,42500,41937,43242,42500,563
15.0,85000,4,0.225,168,42500,41706,42563,42500,794
9.0,85000,4,0.25,168,42500,41580,42760,42500,920
10.0,85000,4,0.25,168,42500,41520,42619,42500,980
5.0,85000,4,0.2,168,42500,41756,66547,42500,744
2.0,85000,3,0.125,126,42500,40277,84780,39521,-756
1.0,85000,2,0.175,84,42659,42659,81855,42612,-47
12.0,85000,4,0.25,168,42500,41816,42522,42500,684
13.0,85000,4,0.225,168,42500,41818,42722,42500,682
6.0,85000,3,0.1,126,42500,41886,84978,41864,-22
14.0,85000,4,0.225,168,42500,41499,42614,42500,1001
2.0,85000,3,0.125,126,42500,40277,84780,39521,-756
7.0,85000,3,0.125,126,42500,41508,84580,40324,-1184
4.0,85000,2,0.1,84,42500,40886,84980,40870,-16
11.0,85000,4,0.25,168,42500,41937,42551,42500,563
15.0,85000,4,0.25,168,42500,41706,42502,42500,794
8.0,85000,4,0.225,168,42500,41390,46069,42500,1110
10.0,85000,5,0.025,210,42500,41202,85000,41202,0
9.0,85000,5,0.025,210,42500,41187,85000,41187,0
5.0,85000,4,0.225,168,42500,41756,54894,42499,743
13.0,85000,4,0.25,168,42500,41818,42509,42500,682
12.0,85000,5,0.025,210,42500,41422,85000,41422,0
14.0,85000,4,0.25,168,42500,41499,42504,42500,1001
2.0,85000,3,0.15,126,42500,40277,83919,40121,-156
11.0,85000,5,0.025,210,42500,41565,85000,41565,0
15.0,85000,5,0.025,210,42500,41613,85000,41613,0
10.0,85000,5,0.05,210,42500,41202,85000,41202,0
9.0,85000,5,0.05,210,42500,41187,85000,41187,0
7.0,85000,3,0.15,126,42500,41508,81575,42359,851
6.0,85000,3,0.125,126,42500,41886,84672,41355,-531
13.0,85000,5,0.025,210,42500,41478,85000,41478,0
12.0,85000,5,0.05,210,42500,41422,85000,41422,0
2.0,85000,3,0.15,126,42500,40277,83919,40121,-156
5.0,85000,4,0.25,168,42500,41756,46735,42495,739
1.0,85000,2,0.2,84,42659,42659,78825,42599,-60
14.0,85000,5,0.025,210,42500,42130,85000,42130,0
11.0,85000,5,0.05,210,42500,41565,85000,41565,0
8.0,85000,5,0.025,210,42500,41162,85000,41162,0
10.0,85000,5,0.075,210,42500,41202,85000,41202,0
15.0,85000,5,0.05,210,42500,41613,85000,41613,0
9.0,85000,5,0.075,210,42500,41187,85000,41187,0
12.0,85000,5,0.075,210,42500,41422,85000,41422,0
13.0,85000,5,0.05,210,42500,41478,85000,41478,0
4.0,85000,2,0.125,84,42500,40886,84806,40363,-523
2.0,85000,3,0.175,126,42500,40277,82000,40153,-124
14.0,85000,5,0.05,210,42500,42130,85000,42130,0
5.0,85000,5,0.025,210,42500,41871,85000,41871,0
7.0,85000,3,0.175,126,42500,41508,72757,42500,992
11.0,85000,5,0.075,210,42500,41565,85000,41565,0
8.0,85000,5,0.05,210,42500,41162,85000,41162,0
10.0,85000,5,0.1,210,42500,41202,84968,41170,-32
15.0,85000,5,0.075,210,42500,41613,84999,41612,-1
2.0,85000,3,0.175,126,42500,40277,82000,40153,-124
9.0,85000,5,0.1,210,42500,41187,84969,41156,-31
6.0,85000,3,0.15,126,42500,41886,82328,42158,272
12.0,85000,5,0.1,210,42500,41422,84952,41377,-45
13.0,85000,5,0.075,210,42500,41478,85000,41478,0
14.0,85000,5,0.075,210,42500,42130,85000,42130,0
1.0,85000,2,0.225,84,42659,42659,74557,42519,-140
5.0,85000,5,0.05,210,42500,41871,85000,41871,0
11.0,85000,5,0.1,210,42500,41565,84959,41526,-39
10.0,85000,5,0.125,210,42500,41202,84205,41723,521
8.0,85000,5,0.075,210,42500,41162,85000,41162,0
15.0,85000,5,0.1,210,42500,41613,84925,40638,-975
9.0,85000,5,0.125,210,42500,41187,84364,41526,339
2.0,85000,3,0.2,126,42500,40277,76968,42217,1940
12.0,85000,5,0.125,210,42500,41422,83740,42352,930
7.0,85000,3,0.2,126,42500,41508,58844,42500,992
13.0,85000,5,0.1,210,42500,41478,84940,41068,-410
14.0,85000,5,0.1,210,42500,42130,84933,42064,-66
2.0,85000,3,0.2,126,42500,40277,76968,42217,1940
6.0,85000,3,0.175,126,42500,41886,74526,42500,614
11.0,85000,5,0.125,210,42500,41565,83994,42195,630
10.0,85000,5,0.15,210,42500,41202,78507,42500,1298
8.0,85000,5,0.1,210,42500,41162,84974,41112,-50
5.0,85000,5,0.075,210,42500,41871,84999,41870,-1
15.0,85000,5,0.125,210,42500,41613,82669,42500,887
4.0,85000,2,0.15,84,42500,40886,83544,41082,196
9.0,85000,5,0.15,210,42500,41187,79887,42477,1290
12.0,85000,5,0.15,210,42500,41422,75654,42500,1078
13.0,85000,5,0.125,210,42500,41478,83422,42381,903
14.0,85000,5,0.125,210,42500,42130,83066,42364,234
1.0,85000,2,0.25,84,42659,42659,68922,42442,-217
7.0,85000,3,0.225,126,42500,41508,47843,42499,991
10.0,85000,5,0.175,210,42500,41202,64095,42500,1298
11.0,85000,5,0.15,210,42500,41565,77151,42500,935
2.0,85000,3,0.225,126,42500,40277,69963,42455,2178
8.0,85000,5,0.125,210,42500,41162,84521,41312,150
15.0,85000,5,0.15,210,42500,41613,70233,42500,887
9.0,85000,5,0.175,210,42500,41187,67255,42500,1313
5.0,85000,5,0.1,210,42500,41871,84979,41850,-21
12.0,85000,5,0.175,210,42500,41422,58777,42500,1078
13.0,85000,5,0.15,210,42500,41478,73938,42500,1022
6.0,85000,3,0.2,126,42500,41886,62613,42500,614
2.0,85000,3,0.225,126,42500,40277,69963,42455,2178
14.0,85000,5,0.15,210,42500,42130,72265,42500,370
10.0,85000,5,0.2,210,42500,41202,49679,42500,1298
11.0,85000,5,0.175,210,42500,41565,61700,42500,935
15.0,85000,5,0.175,210,42500,41613,51823,42500,887
8.0,85000,5,0.15,210,42500,41162,80838,42437,1275
9.0,85000,5,0.2,210,42500,41187,52385,42500,1313
7.0,85000,3,0.25,126,42500,41508,43634,42500,992
12.0,85000,5,0.2,210,42500,41422,46240,42500,1078
5.0,85000,5,0.125,210,42500,41871,84728,41509,-362
13.0,85000,5,0.175,210,42500,41478,56118,42500,1022
2.0,85000,3,0.25,126,42500,40277,62527,42467,2190
4.0,85000,2,0.175,84,42500,40886,79599,42426,1540
14.0,85000,5,0.175,210,42500,42130,53901,42500,370
10.0,85000,5,0.225,210,42500,41202,43674,42500,1298
11.0,85000,5,0.2,210,42500,41565,47713,42500,935
1.0,85000,3,0.025,126,42675,42675,84999,42675,0
8.0,85000,5,0.175,210,42500,41162,70205,42500,1338
15.0,85000,5,0.2,210,42500,41613,43640,42500,887
9.0,85000,5,0.225,210,42500,41187,44505,42500,1313
2.0,85000,3,0.25,126,42500,40277,62527,42467,2190
12.0,85000,5,0.225,210,42500,41422,42845,42500,1078
6.0,85000,3,0.225,126,42500,41886,50768,42499,613
5.0,85000,5,0.15,210,42500,41871,83009,41529,-342
10.0,85000,5,0.25,210,42500,41202,42603,42500,1298
7.0,85000,4,0.025,168,42500,41474,85000,41474,0
13.0,85000,5,0.2,210,42500,41478,45020,42500,1022
14.0,85000,5,0.2,210,42500,42130,44220,42500,370
11.0,85000,5,0.225,210,42500,41565,43141,42500,935
9.0,85000,5,0.25,210,42500,41187,42718,42500,1313
8.0,85000,5,0.2,210,42500,41162,55330,42500,1338
12.0,85000,5,0.25,210,42500,41422,42518,42500,1078
15.0,85000,5,0.225,210,42500,41613,42557,42500,887
2.0,85000,4,0.025,168,42501,40324,85000,40324,0
5.0,85000,5,0.175,210,42500,41871,77612,42476,605
10.0,85000,6,0.025,252,42500,41417,85000,41417,0
14.0,85000,5,0.225,210,42500,42130,42611,42500,370
11.0,85000,5,0.25,210,42500,41565,42550,42500,935
2.0,85000,4,0.025,168,42501,40324,85000,40324,0
13.0,85000,5,0.225,210,42500,41478,42697,42500,1022
8.0,85000,5,0.225,210,42500,41162,45938,42500,1338
6.0,85000,3,0.25,126,42500,41886,44604,42498,612
9.0,85000,6,0.025,252,42500,41444,85000,41444,0
15.0,85000,5,0.25,210,42500,41613,42500,42499,886
12.0,85000,6,0.025,252,42500,41962,85000,41962,0
7.0,85000,4,0.05,168,42500,41474,85000,41474,0
1.0,85000,3,0.05,126,42675,42675,84996,42675,0
4.0,85000,2,0.2,84,42500,40886,70121,42500,1614
5.0,85000,5,0.2,210,42500,41871,66271,42500,629
10.0,85000,6,0.05,252,42500,41417,85000,41417,0
14.0,85000,5,0.25,210,42500,42130,42503,42500,370
11.0,85000,6,0.025,252,42500,41809,85000,41809,0
8.0,85000,5,0.25,210,42500,41162,42990,42499,1337
2.0,85000,4,0.05,168,42501,40324,85000,40324,0
9.0,85000,6,0.05,252,42500,41444,85000,41444,0
12.0,85000,6,0.05,252,42500,41962,85000,41962,0
13.0,85000,5,0.25,210,42500,41478,42507,42500,1022
15.0,85000,6,0.025,252,42500,42197,85000,42197,0
5.0,85000,5,0.225,210,42500,41871,54420,42500,629
2.0,85000,4,0.05,168,42501,40324,85000,40324,0
10.0,85000,6,0.075,252,42500,41417,84999,41416,-1
14.0,85000,6,0.025,252,42500,41883,85000,41883,0
7.0,85000,4,0.075,168,42500,41474,84998,41472,-2
11.0,85000,6,0.05,252,42500,41809,85000,41809,0
8.0,85000,6,0.025,252,42500,41579,85000,41579,0
6.0,85000,4,0.025,168,42500,41389,85000,41389,0
9.0,85000,6,0.075,252,42500,41444,84999,41443,-1
12.0,85000,6,0.075,252,42500,41962,84999,41961,-1
15.0,85000,6,0.05,252,42500,42197,85000,42197,0
1.0,85000,3,0.075,126,42675,42675,84984,42673,-2
13.0,85000,6,0.025,252,42500,41635,85000,41635,0
5.0,85000,5,0.25,210,42500,41871,46421,42494,623
10.0,85000,6,0.1,252,42500,41417,84967,41353,-64
14.0,85000,6,0.05,252,42500,41883,85000,41883,0
2.0,85000,4,0.075,168,42501,40324,84996,40324,0
11.0,85000,6,0.075,252,42500,41809,84999,41808,-1
4.0,85000,2,0.225,84,42500,40886,59443,42499,1613
8.0,85000,6,0.05,252,42500,41579,85000,41579,0
9.0,85000,6,0.1,252,42500,41444,84968,41412,-32
12.0,85000,6,0.1,252,42500,41962,84947,41909,-53
7.0,85000,4,0.1,168,42500,41474,84974,41409,-65
2.0,85000,4,0.075,168,42501,40324,84996,40324,0
15.0,85000,6,0.075,252,42500,42197,84999,42196,-1
10.0,85000,6,0.125,252,42500,41417,84160,41265,-152
5.0,85000,6,0.025,252,42500,42006,85000,42006,0
14.0,85000,6,0.075,252,42500,41883,85000,41883,0
11.0,85000,6,0.1,252,42500,41809,84949,41759,-50
13.0,85000,6,0.05,252,42500,41635,85000,41635,0
8.0,85000,6,0.075,252,42500,41579,85000,41579,0
6.0,85000,4,0.05,168,42500,41389,85000,41389,0
9.0,85000,6,0.125,252,42500,41444,84350,41634,190
12.0,85000,6,0.125,252,42500,41962,83771,41832,-130
15.0,85000,6,0.1,252,42500,42197,84925,42016,-181
2.0,85000,4,0.1,168,42501,40324,84970,40324,0
10.0,85000,6,0.15,252,42500,41417,78651,42500,1083
1.0,85000,3,0.1,126,42675,42675,84901,42674,-1
5.0,85000,6,0.05,252,42500,42006,85000,42006,0
7.0,85000,4,0.125,168,42500,41474,84593,41777,303
14.0,85000,6,0.1,252,42500,41883,84927,41223,-660
11.0,85000,6,0.125,252,42500,41809,83996,41508,-301
8.0,85000,6,0.1,252,42500,41579,84976,41532,-47
2.0,85000,4,0.1,168,42501,40324,84970,40324,0
12.0,85000,6,0.15,252,42500,41962,75691,42500,538
9.0,85000,6,0.15,252,42500,41444,79830,42500,1056
4.0,85000,2,0.25,84,42500,40886,50110,42493,1607
13.0,85000,6,0.075,252,42500,41635,85000,41635,0
15.0,85000,6,0.125,252,42500,42197,82822,42451,254
10.0,85000,6,0.175,252,42500,41417,64258,42500,1083
11.0,85000,6,0.15,252,42500,41809,77217,42500,691
14.0,85000,6,0.125,252,42500,41883,83144,42367,484
5.0,85000,6,0.075,252,42500,42006,84999,42005,-1
6.0,85000,4,0.075,168,42500,41389,85000,41389,0
8.0,85000,6,0.125,252,42500,41579,84469,41613,34
12.0,85000,6,0.175,252,42500,41962,58862,42500,538
9.0,85000,6,0.175,252,42500,41444,67297,42500,1056
2.0,85000,4,0.125,168,42501,40324,84769,40350,26
7.0,85000,4,0.15,168,42500,41474,81648,42446,972
13.0,85000,6,0.1,252,42500,41635,84935,41571,-64
10.0,85000,6,0.2,252,42500,41417,49752,42500,1083
15.0,85000,6,0.15,252,42500,42197,70477,42500,303
2.0,85000,4,0.125,168,42501,40324,84769,40350,26
11.0,85000,6,0.175,252,42500,41809,61724,42500,691
14.0,85000,6,0.15,252,42500,41883,72410,42500,617
1.0,85000,3,0.125,126,42675,42675,84557,42666,-9
12.0,85000,6,0.2,252,42500,41962,46332,42500,538
5.0,85000,6,0.1,252,42500,42006,84981,41987,-19
9.0,85000,6,0.2,252,42500,41444,52474,42500,1056
8.0,85000,6,0.15,252,42500,41579,80876,42438,859
10.0,85000,6,0.225,252,42500,41417,43705,42500,1083
13.0,85000,6,0.125,252,42500,41635,83459,42334,699
15.0,85000,6,0.175,252,42500,42197,51924,42500,303
7.0,85000,4,0.175,168,42500,41474,72828,42500,1026
4.0,85000,3,0.025,126,42500,41073,85000,41073,0
11.0,85000,6,0.2,252,42500,41809,47841,42500,691
14.0,85000,6,0.175,252,42500,41883,53968,42500,617
12.0,85000,6,0.225,252,42500,41962,42867,42500,538
6.0,85000,4,0.1,168,42500,41389,84974,41364,-25
2.0,85000,4,0.15,168,42501,40324,83839,42221,1897
9.0,85000,6,0.225,252,42500,41444,44590,42500,1056
8.0,85000,6,0.175,252,42500,41579,70414,42500,921
5.0,85000,6,0.125,252,42500,42006,84726,41639,-367
10.0,85000,6,0.25,252,42500,41417,42597,42500,1083
13.0,85000,6,0.15,252,42500,41635,74043,42500,865
2.0,85000,4,0.15,168,42501,40324,83839,42221,1897
15.0,85000,6,0.2,252,42500,42197,43683,42500,303
11.0,85000,6,0.225,252,42500,41809,43183,42500,691
14.0,85000,6,0.2,252,42500,41883,44257,42500,617
12.0,85000,6,0.25,252,42500,41962,42513,42500,538
9.0,85000,6,0.25,252,42500,41444,42724,42500,1056
1.0,85000,3,0.15,126,42675,42675,83603,42654,-21
8.0,85000,6,0.2,252,42500,41579,55100,42500,921
7.0,85000,4,0.2,168,42500,41474,59057,42500,1026
10.0,85000,7,0.025,294,42500,40744,85000,40744,0
5.0,85000,6,0.15,252,42500,42006,83025,41776,-230
13.0,85000,6,0.175,252,42500,41635,56248,42500,865
11.0,85000,6,0.25,252,42500,41809,42539,42500,691
14.0,85000,6,0.225,252,42500,41883,42605,42500,617
15.0,85000,6,0.225,252,42500,42197,42551,42500,303
2.0,85000,4,0.175,168,42501,40324,81858,42222,1898
12.0,85000,7,0.025,294,42500,42069,85000,42069,0
9.0,85000,7,0.025,294,42500,41301,85000,41301,0
8.0,85000,6,0.225,252,42500,41579,45994,42500,921
6.0,85000,4,0.125,168,42500,41389,84670,40788,-601
10.0,85000,7,0.05,294,42500,40744,85000,40744,0
2.0,85000,4,0.175,168,42501,40324,81858,42222,1898
4.0,85000,3,0.05,126,42500,41073,85000,41073,0
13.0,85000,6,0.2,252,42500,41635,45050,42500,865
15.0,85000,6,0.25,252,42500,42197,42501,42500,303
5.0,85000,6,0.175,252,42500,42006,77760,42482,476
14.0,85000,6,0.25,252,42500,41883,42502,42500,617
11.0,85000,7,0.025,294,42500,41910,85000,41910,0
7.0,85000,4,0.225,168,42500,41474,48140,42500,1026
12.0,85000,7,0.05,294,42500,42069,85000,42069,0
9.0,85000,7,0.05,294,42500,41301,85000,41301,0
8.0,85000,6,0.25,252,42500,41579,43055,42500,921
10.0,85000,7,0.075,294,42500,40744,84999,40743,-1
2.0,85000,4,0.2,168,42501,40324,76531,42477,2153
13.0,85000,6,0.225,252,42500,41635,42703,42500,865
11.0,85000,7,0.05,294,42500,41910,85000,41910,0
15.0,85000,7,0.025,294,42500,42187,85000,42187,0
14.0,85000,7,0.025,294,42500,42120,85000,42120,0
5.0,85000,6,0.2,252,42500,42006,66417,42500,494
12.0,85000,7,0.075,294,42500,42069,85000,42069,0
9.0,85000,7,0.075,294,42500,41301,84999,41301,0
8.0,85000,7,0.025,294,42500,41477,85000,41477,0
2.0,85000,4,0.2,168,42501,40324,76531,42477,2153
7.0,85000,4,0.25,168,42500,41474,43712,42499,1025
10.0,85000,7,0.1,294,42500,40744,84951,41504,760
13.0,85000,6,0.25,252,42500,41635,42505,42500,865
6.0,85000,4,0.15,168,42500,41389,82406,42323,934
11.0,85000,7,0.075,294,42500,41910,85000,41910,0
14.0,85000,7,0.05,294,42500,42120,85000,42120,0
15.0,85000,7,0.05,294,42500,42187,85000,42187,0
12.0,85000,7,0.1,294,42500,42069,84938,42008,-61
4.0,85000,3,0.075,126,42500,41073,85000,41073,0
5.0,85000,6,0.225,252,42500,42006,54687,42500,494
9.0,85000,7,0.1,294,42500,41301,84958,41301,0
8.0,85000,7,0.05,294,42500,41477,85000,41477,0
10.0,85000,7,0.125,294,42500,40744,83948,42077,1333
13.0,85000,7,0.025,294,42500,41667,85000,41667,0
7.0,85000,5,0.025,210,42500,41117,85000,41117,0
11.0,85000,7,0.1,294,42500,41910,84942,41637,-273
2.0,85000,4,0.225,168,42501,40324,69266,42481,2157
14.0,85000,7,0.075,294,42500,42120,84999,42119,-1
15.0,85000,7,0.075,294,42500,42187,84998,42185,-2
12.0,85000,7,0.125,294,42500,42069,83460,42233,164
9.0,85000,7,0.125,294,42500,41301,84204,41356,55
8.0,85000,7,0.075,294,42500,41477,84998,41477,0
5.0,85000,6,0.25,252,42500,42006,46579,42496,490
10.0,85000,7,0.15,294,42500,40744,77760,42500,1756
11.0,85000,7,0.125,294,42500,41910,83717,41546,-364
13.0,85000,7,0.05,294,42500,41667,85000,41667,0
6.0,85000,4,0.175,168,42500,41389,74693,42500,1111
14.0,85000,7,0.1,294,42500,42120,84905,42029,-91
12.0,85000,7,0.15,294,42500,42069,74428,42500,431
9.0,85000,7,0.15,294,42500,41301,79222,42500,1199
7.0,85000,5,0.05,210,42500,41117,85000,41117,0
8.0,85000,7,0.1,294,42500,41477,84971,41477,0
4.0,85000,3,0.1,126,42500,41073,84985,41023,-50
15.0,85000,7,0.1,294,42500,42187,84886,41918,-269
10.0,85000,7,0.175,294,42500,40744,62844,42500,1756
5.0,85000,7,0.025,294,42500,41768,85000,41768,0
2.0,85000,4,0.25,168,42501,40324,61770,42463,2139
11.0,85000,7,0.15,294,42500,41910,76321,42500,590
14.0,85000,7,0.125,294,42500,42120,82677,42410,290
12.0,85000,7,0.175,294,42500,42069,57561,42500,431
9.0,85000,7,0.175,294,42500,41301,66081,42500,1199
13.0,85000,7,0.075,294,42500,41667,85000,41667,0
8.0,85000,7,0.125,294,42500,41477,84385,41477,0
10.0,85000,7,0.2,294,42500,40744,49240,42500,1756
15.0,85000,7,0.125,294,42500,42187,82240,42401,214
5.0,85000,7,0.05,294,42500,41768,85000,41768,0
7.0,85000,5,0.075,210,42500,41117,85000,41117,0
11.0,85000,7,0.175,294,42500,41910,60402,42500,590
12.0,85000,7,0.2,294,42500,42069,45961,42500,431
14.0,85000,7,0.15,294,42500,42120,70933,42500,380
9.0,85000,7,0.2,294,42500,41301,51739,42500,1199
10.0,85000,7,0.225,294,42500,40744,43560,42500,1756
8.0,85000,7,0.15,294,42500,41477,80253,42463,986
15.0,85000,7,0.15,294,42500,42187,68726,42500,313
13.0,85000,7,0.1,294,42500,41667,84934,41474,-193
11.0,85000,7,0.2,294,42500,41910,47333,42500,590
12.0,85000,7,0.225,294,42500,42069,42829,42500,431
9.0,85000,7,0.225,294,42500,41301,44331,42500,1199
14.0,85000,7,0.175,294,42500,42120,52713,42500,380
10.0,85000,7,0.25,294,42500,40744,42587,42500,1756
8.0,85000,7,0.175,294,42500,41477,69220,42500,1023
15.0,85000,7,0.175,294,42500,42187,50717,42500,313
11.0,85000,7,0.225,294,42500,41910,43118,42500,590
13.0,85000,7,0.125,294,42500,41667,83062,42416,749
12.0,85000,7,0.25,294,42500,42069,42509,42499,430
9.0,85000,7,0.25,294,42500,41301,42694,42500,1199
14.0,85000,7,0.2,294,42500,42120,44073,42500,380
10.0,85000,8,0.025,336,42500,41654,85000,41654,0
15.0,85000,7,0.2,294,42500,42187,43574,42500,313
11.0,85000,7,0.25,294,42500,41910,42537,42500,590
12.0,85000,8,0.025,336,42500,41751,85000,41751,0
14.0,85000,7,0.225,294,42500,42120,42591,42499,379
13.0,85000,7,0.15,294,42500,41667,72647,42500,833
10.0,85000,8,0.05,336,42500,41654,85000,41654,0
15.0,85000,7,0.225,294,42500,42187,42541,42500,313
11.0,85000,8,0.025,336,42500,41357,85000,41357,0
12.0,85000,8,0.05,336,42500,41751,85000,41751,0
14.0,85000,7,0.25,294,42500,42120,42502,42499,379
15.0,85000,7,0.25,294,42500,42187,42500,42500,313
8.0,85000,4,0.25,168,42500,41390,43041,42498,1108
3.0,85000,0,0.025,0,42500,40322,85000,40322,0
7.0,85000,5,0.1,210,42500,41117,84976,41094,-23
6.0,85000,4,0.2,168,42500,41389,62707,42500,1111
9.0,85000,8,0.025,336,42500,41188,85000,41188,0
5.0,85000,7,0.075,294,42500,41768,84999,41767,-1
14.0,85000,8,0.025,336,42500,41892,85000,41892,0
4.0,85000,3,0.125,126,42500,41073,84782,40529,-544
2.0,85000,5,0.025,210,42501,40477,85000,40477,0
13.0,85000,7,0.175,294,42500,41667,54936,42500,833
12.0,85000,8,0.075,336,42500,41751,85000,41751,0
1.0,85000,3,0.175,126,42675,42675,82331,42644,-31
11.0,85000,8,0.05,336,42500,41357,85000,41357,0
10.0,85000,8,0.075,336,42500,41654,85000,41654,0
15.0,85000,8,0.025,336,42500,41419,85000,41419,0
3.0,85000,0,0.05,0,42500,40322,85000,40322,0
8.0,85000,7,0.2,294,42500,41477,54694,42500,1023
7.0,85000,5,0.125,210,42500,41117,84633,40907,-210
6.0,85000,4,0.225,168,42500,41389,51152,42500,1111
9.0,85000,8,0.05,336,42500,41188,85000,41188,0
5.0,85000,7,0.1,294,42500,41768,84975,41732,-36
14.0,85000,8,0.05,336,42500,41892,85000,41892,0
4.0,85000,3,0.15,126,42500,41073,83396,41186,113
2.0,85000,5,0.05,210,42501,40477,85000,40477,0
15.0,85000,8,0.05,336,42500,41419,85000,41419,0
13.0,85000,7,0.2,294,42500,41667,44872,42499,832
1.0,85000,3,0.2,126,42675,42675,78655,42609,-66
12.0,85000,8,0.1,336,42500,41751,84931,41751,0
11.0,85000,8,0.075,336,42500,41357,85000,41357,0
3.0,85000,0,0.075,0,42500,40322,84997,40320,-2
8.0,85000,7,0.225,294,42500,41477,45693,42500,1023
10.0,85000,8,0.1,336,42500,41654,84956,41654,0
6.0,85000,4,0.25,168,42500,41389,44751,42499,1110
7.0,85000,5,0.15,210,42500,41117,81811,42293,1176
5.0,85000,7,0.125,294,42500,41768,84673,41344,-424
9.0,85000,8,0.075,336,42500,41188,85000,41188,0
15.0,85000,8,0.075,336,42500,41419,85000,41419,0
14.0,85000,8,0.075,336,42500,41892,85000,41892,0
4.0,85000,3,0.175,126,42500,41073,79468,42373,1300
2.0,85000,5,0.075,210,42501,40477,84995,40445,-32
13.0,85000,7,0.225,294,42500,41667,42657,42499,832
8.0,85000,7,0.25,294,42500,41477,42953,42500,1023
3.0,85000,0,0.1,0,42500,40322,84969,40221,-101
15.0,85000,8,0.1,336,42500,41419,84878,41419,0
6.0,85000,5,0.025,210,42500,41631,85000,41631,0
7.0,85000,5,0.175,210,42500,41117,72961,42500,1383
9.0,85000,8,0.1,336,42500,41188,84956,41146,-42
5.0,85000,7,0.15,294,42500,41768,82840,41934,166
12.0,85000,8,0.125,336,42500,41751,83467,42387,636
1.0,85000,3,0.225,126,42675,42675,74295,42569,-106
14.0,85000,8,0.1,336,42500,41892,84914,41807,-85
11.0,85000,8,0.1,336,42500,41357,84932,41357,0
4.0,85000,3,0.2,126,42500,41073,70741,42500,1427
10.0,85000,8,0.125,336,42500,41654,84057,42164,510
2.0,85000,5,0.1,210,42501,40477,84966,40378,-99
15.0,85000,8,0.125,336,42500,41419,82265,42452,1033
3.0,85000,0,0.125,0,42500,40322,84773,39016,-1306
8.0,85000,8,0.025,336,42500,40468,85000,40468,0
13.0,85000,7,0.25,294,42500,41667,42504,42498,831
7.0,85000,5,0.2,210,42500,41117,58752,42500,1383
6.0,85000,5,0.05,210,42500,41631,85000,41631,0
9.0,85000,8,0.125,336,42500,41188,84220,41238,50
5.0,85000,7,0.175,294,42500,41768,77217,42482,714
14.0,85000,8,0.125,336,42500,41892,82682,42228,336
4.0,85000,3,0.225,126,42500,41073,59420,42499,1426
2.0,85000,5,0.125,210,42501,40477,84770,39830,-647
12.0,85000,8,0.15,336,42500,41751,74560,42500,749
11.0,85000,8,0.125,336,42500,41357,83793,42364,1007
1.0,85000,3,0.25,126,42675,42675,68727,42468,-207
15.0,85000,8,0.15,336,42500,41419,68897,42500,1081
10.0,85000,8,0.15,336,42500,41654,77842,42500,846
3.0,85000,0,0.15,0,42500,40322,83798,40075,-247
8.0,85000,8,0.05,336,42500,40468,85000,40468,0
7.0,85000,5,0.225,210,42500,41117,47969,42500,1383
6.0,85000,5,0.075,210,42500,41631,84999,41630,-1
9.0,85000,8,0.15,336,42500,41188,79272,42500,1312
5.0,85000,7,0.2,294,42500,41768,65855,42500,732
15.0,85000,8,0.175,336,42500,41419,50821,42500,1081
14.0,85000,8,0.15,336,42500,41892,70787,42500,608
4.0,85000,3,0.25,126,42500,41073,49893,42494,1421
13.0,85000,8,0.025,336,42500,41165,85000,41165,0
2.0,85000,5,0.15,210,42501,40477,83913,39997,-480
12.0,85000,8,0.175,336,42500,41751,57529,42500,749
11.0,85000,8,0.15,336,42500,41357,76261,42500,1143
3.0,85000,0,0.175,0,42500,40322,80398,42044,1722
7.0,85000,5,0.25,210,42500,41117,43621,42500,1383
8.0,85000,8,0.075,336,42500,40468,85000,40468,0
15.0,85000,8,0.2,336,42500,41419,43505,42500,1081
1.0,85000,4,0.025,168,42637,42637,85000,42637,0
10.0,85000,8,0.175,336,42500,41654,62950,42500,846
6.0,85000,5,0.1,210,42500,41631,84974,41574,-57
9.0,85000,8,0.175,336,42500,41188,65927,42500,1312
5.0,85000,7,0.225,294,42500,41768,54233,42499,731
14.0,85000,8,0.175,336,42500,41892,52676,42500,608
4.0,85000,4,0.025,168,42500,41100,85000,41100,0
15.0,85000,8,0.225,336,42500,41419,42543,42500,1081
13.0,85000,8,0.05,336,42500,41165,85000,41165,0
2.0,85000,5,0.175,210,42501,40477,82000,40027,-450
3.0,85000,0,0.2,0,42500,40322,73945,42463,2141
8.0,85000,8,0.1,336,42500,40468,84972,40732,264
7.0,85000,6,0.025,252,42500,41418,85000,41418,0
12.0,85000,8,0.2,336,42500,41751,45865,42500,749
9.0,85000,8,0.2,336,42500,41188,51872,42500,1312
15.0,85000,8,0.25,336,42500,41419,42500,42500,1081
6.0,85000,5,0.125,210,42500,41631,84698,40971,-660
14.0,85000,8,0.2,336,42500,41892,44013,42500,608
5.0,85000,7,0.25,294,42500,41768,46288,42498,730
11.0,85000,8,0.175,336,42500,41357,60437,42500,1143
1.0,85000,4,0.05,168,42637,42637,84993,42636,-1
10.0,85000,8,0.2,336,42500,41654,49212,42500,846
4.0,85000,4,0.05,168,42500,41100,85000,41100,0
2.0,85000,5,0.2,210,42501,40477,77093,42166,1689
3.0,85000,0,0.225,0,42500,40322,64454,42497,2175
8.0,85000,8,0.125,336,42500,40468,84396,40732,264
7.0,85000,6,0.05,252,42500,41418,85000,41418,0
15.0,85000,9,0.025,378,42500,41721,85000,41721,0
13.0,85000,8,0.075,336,42500,41165,85000,41165,0
9.0,85000,8,0.225,336,42500,41188,44432,42498,1310
14.0,85000,8,0.225,336,42500,41892,42579,42500,608
6.0,85000,5,0.15,210,42500,41631,82474,42199,568
12.0,85000,8,0.225,336,42500,41751,42836,42500,749
5.0,85000,8,0.025,336,42500,41923,85000,41923,0
4.0,85000,4,0.075,168,42500,41100,84998,41098,-2
3.0,85000,0,0.25,0,42500,40322,54433,42484,2162
1.0,85000,4,0.075,168,42637,42637,84981,42636,-1
2.0,85000,5,0.225,210,42501,40477,69998,42438,1961
11.0,85000,8,0.2,336,42500,41357,47262,42500,1143
9.0,85000,8,0.25,336,42500,41188,42705,42497,1309
8.0,85000,8,0.15,336,42500,40468,80323,42463,1995
10.0,85000,8,0.225,336,42500,41654,43620,42499,845
7.0,85000,6,0.075,252,42500,41418,84999,41417,-1
14.0,85000,8,0.25,336,42500,41892,42502,42500,608
15.0,85000,9,0.05,378,42500,41721,85000,41721,0
6.0,85000,5,0.175,210,42500,41631,74898,42489,858
5.0,85000,8,0.05,336,42500,41923,85000,41923,0
3.0,85000,1,0.025,42,42500,42039,85000,42039,0
13.0,85000,8,0.1,336,42500,41165,84921,40779,-386
12.0,85000,8,0.25,336,42500,41751,42512,42499,748
2.0,85000,5,0.25,210,42501,40477,62320,42461,1984
4.0,85000,4,0.1,168,42500,41100,84975,41068,-32
1.0,85000,4,0.1,168,42637,42637,84899,42631,-6
8.0,85000,8,0.175,336,42500,40468,69353,42500,2032
7.0,85000,6,0.1,252,42500,41418,84978,41216,-202
9.0,85000,9,0.025,378,42500,42056,85000,42056,0
14.0,85000,9,0.025,378,42500,41888,85000,41888,0
15.0,85000,9,0.075,378,42500,41721,84998,41719,-2
6.0,85000,5,0.2,210,42500,41631,62439,42500,869
11.0,85000,8,0.225,336,42500,41357,43106,42500,1143
10.0,85000,8,0.25,336,42500,41654,42574,42499,845
5.0,85000,8,0.075,336,42500,41923,85000,41923,0
3.0,85000,1,0.05,42,42500,42039,85000,42039,0
2.0,85000,6,0.025,252,42501,40107,85000,40107,0
4.0,85000,4,0.125,168,42500,41100,84800,40610,-490
8.0,85000,8,0.2,336,42500,40468,54441,42500,2032
7.0,85000,6,0.125,252,42500,41418,84605,40494,-924
9.0,85000,9,0.05,378,42500,42056,85000,42056,0
14.0,85000,9,0.05,378,42500,41888,85000,41888,0
13.0,85000,8,0.125,336,42500,41165,83112,42377,1212
1.0,85000,4,0.125,168,42637,42637,84571,42629,-8
12.0,85000,9,0.025,378,42500,42156,85000,42156,0
6.0,85000,5,0.225,210,42500,41631,50800,42500,869
15.0,85000,9,0.1,378,42500,41721,84855,41980,259
3.0,85000,1,0.075,42,42500,42039,85000,42039,0
5.0,85000,8,0.1,336,42500,41923,84984,41895,-28
2.0,85000,6,0.05,252,42501,40107,85000,40107,0
11.0,85000,8,0.25,336,42500,41357,42530,42500,1143
4.0,85000,4,0.15,168,42500,41100,83477,41400,300
8.0,85000,8,0.225,336,42500,40468,45750,42499,2031
7.0,85000,6,0.15,252,42500,41418,81781,42398,980
10.0,85000,9,0.025,378,42500,40742,85000,40742,0
9.0,85000,9,0.075,378,42500,42056,85000,42056,0
14.0,85000,9,0.075,378,42500,41888,84998,41886,-2
6.0,85000,5,0.25,210,42500,41631,44669,42498,867
15.0,85000,9,0.125,378,42500,41721,82011,42500,779
3.0,85000,1,0.1,42,42500,42039,84974,41999,-40
1.0,85000,4,0.15,168,42637,42637,83577,42618,-19
5.0,85000,8,0.125,336,42500,41923,84676,41457,-466
2.0,85000,6,0.075,252,42501,40107,84996,40107,0
13.0,85000,8,0.15,336,42500,41165,72752,42500,1335
8.0,85000,8,0.25,336,42500,40468,42968,42496,2028
12.0,85000,9,0.05,378,42500,42156,85000,42156,0
4.0,85000,4,0.175,168,42500,41100,79508,42403,1303
7.0,85000,6,0.175,252,42500,41418,72986,42500,1082
9.0,85000,9,0.1,378,42500,42056,84952,42008,-48
14.0,85000,9,0.1,378,42500,41888,84884,41631,-257
6.0,85000,6,0.025,252,42500,41625,85000,41625,0
11.0,85000,9,0.025,378,42500,41514,85000,41514,0
3.0,85000,1,0.125,42,42500,42039,84798,41800,-239
15.0,85000,9,0.15,378,42500,41721,68533,42500,779
5.0,85000,8,0.15,336,42500,41923,82849,41661,-262
10.0,85000,9,0.05,378,42500,40742,85000,40742,0
2.0,85000,6,0.1,252,42501,40107,84943,40107,0
1.0,85000,4,0.175,168,42637,42637,82273,42607,-30
8.0,85000,9,0.025,378,42500,42150,85000,42150,0
4.0,85000,4,0.2,168,42500,41100,70993,42500,1400
7.0,85000,6,0.2,252,42500,41418,58827,42500,1082
9.0,85000,9,0.125,378,42500,42056,84105,41898,-158
14.0,85000,9,0.125,378,42500,41888,82511,42367,479
6.0,85000,6,0.05,252,42500,41625,85000,41625,0
3.0,85000,1,0.15,42,42500,42039,83885,40688,-1351
13.0,85000,8,0.175,336,42500,41165,54919,42500,1335
12.0,85000,9,0.075,378,42500,42156,84999,42155,-1
15.0,85000,9,0.175,378,42500,41721,50466,42500,779
2.0,85000,6,0.125,252,42501,40107,84742,40223,116
5.0,85000,8,0.175,336,42500,41923,77210,42458,535
8.0,85000,9,0.05,378,42500,42150,85000,42150,0
7.0,85000,6,0.225,252,42500,41418,47976,42500,1082
1.0,85000,4,0.2,168,42637,42637,78554,42571,-66
11.0,85000,9,0.05,378,42500,41514,85000,41514,0
4.0,85000,4,0.225,168,42500,41100,59719,42497,1397
9.0,85000,9,0.15,378,42500,42056,78986,42478,422
3.0,85000,1,0.175,42,42500,42039,80510,42005,-34
14.0,85000,9,0.15,378,42500,41888,70601,42500,612
6.0,85000,6,0.075,252,42500,41625,84998,41623,-2
10.0,85000,9,0.075,378,42500,40742,85000,40742,0
15.0,85000,9,0.2,378,42500,41721,43467,42500,779
2.0,85000,6,0.15,252,42501,40107,83765,42212,2105
5.0,85000,8,0.2,336,42500,41923,65752,42500,577
13.0,85000,8,0.2,336,42500,41165,44792,42500,1335
7.0,85000,6,0.25,252,42500,41418,43701,42500,1082
8.0,85000,9,0.075,378,42500,42150,85000,42150,0
4.0,85000,4,0.25,168,42500,41100,50287,42495,1395
12.0,85000,9,0.1,378,42500,42156,84906,41904,-252
3.0,85000,1,0.2,42,42500,42039,74316,42481,442
9.0,85000,9,0.175,378,42500,42056,65517,42500,444
1.0,85000,4,0.225,168,42637,42637,74066,42521,-116
14.0,85000,9,0.175,378,42500,41888,52306,42500,612
6.0,85000,6,0.1,252,42500,41625,84980,41605,-20
15.0,85000,9,0.225,378,42500,41721,42528,42500,779
2.0,85000,6,0.175,252,42501,40107,81827,42213,2106
5.0,85000,8,0.225,336,42500,41923,54128,42499,576
11.0,85000,9,0.075,378,42500,41514,85000,41514,0
7.0,85000,7,0.025,294,42500,40890,85000,40890,0
10.0,85000,9,0.1,378,42500,40742,84943,40742,0
8.0,85000,9,0.1,378,42500,42150,84956,42106,-44
3.0,85000,1,0.225,42,42500,42039,64748,42492,453
4.0,85000,5,0.025,210,42500,41473,85000,41473,0
14.0,85000,9,0.2,378,42500,41888,43929,42500,612
9.0,85000,9,0.2,378,42500,42056,51256,42500,444
13.0,85000,8,0.225,336,42500,41165,42662,42500,1335
15.0,85000,9,0.25,378,42500,41721,42500,42500,779
6.0,85000,6,0.125,252,42500,41625,84686,41001,-624
1.0,85000,4,0.25,168,42637,42637,68445,42421,-216
5.0,85000,8,0.25,336,42500,41923,46384,42498,575
2.0,85000,6,0.2,252,42501,40107,76913,42461,2354
12.0,85000,9,0.125,378,42500,42156,83335,42386,230
7.0,85000,7,0.05,294,42500,40890,85000,40890,0
3.0,85000,1,0.25,42,42500,42039,54703,42479,440
14.0,85000,9,0.225,378,42500,41888,42576,42500,612
8.0,85000,9,0.125,378,42500,42150,84313,41148,-1002
9.0,85000,9,0.225,378,42500,42056,44436,42500,444
4.0,85000,5,0.05,210,42500,41473,85000,41473,0
6.0,85000,6,0.15,252,42500,41625,82441,42272,647
11.0,85000,9,0.1,378,42500,41514,84924,41440,-74
13.0,85000,8,0.25,336,42500,41165,42503,42500,1335
1.0,85000,5,0.025,210,42671,42671,85000,42671,0
10.0,85000,9,0.125,378,42500,40742,83904,42178,1436
2.0,85000,6,0.225,252,42501,40107,70139,42481,2374
5.0,85000,9,0.025,378,42500,41930,85000,41930,0
3.0,85000,2,0.025,84,42500,42068,85000,42068,0
7.0,85000,7,0.075,294,42500,40890,85000,40890,0
14.0,85000,9,0.25,378,42500,41888,42500,42500,612
9.0,85000,9,0.25,378,42500,42056,42705,42500,444
8.0,85000,9,0.15,378,42500,42150,80191,42443,293
4.0,85000,5,0.075,210,42500,41473,84997,41470,-3
6.0,85000,6,0.175,252,42500,41625,74917,42500,875
12.0,85000,9,0.15,378,42500,42156,74269,42500,344
2.0,85000,6,0.25,252,42501,40107,60788,42452,2345
3.0,85000,2,0.05,84,42500,42068,85000,42068,0
5.0,85000,9,0.05,378,42500,41930,85000,41930,0
7.0,85000,7,0.1,294,42500,40890,84975,40865,-25
1.0,85000,5,0.05,210,42671,42671,84998,42671,0
8.0,85000,9,0.175,378,42500,42150,68793,42500,350
11.0,85000,9,0.125,378,42500,41514,83636,42263,749
13.0,85000,9,0.025,378,42500,41809,85000,41809,0
6.0,85000,6,0.2,252,42500,41625,62552,42500,875
4.0,85000,5,0.1,210,42500,41473,84987,41433,-40
10.0,85000,9,0.15,378,42500,40742,77499,42500,1758
2.0,85000,7,0.025,294,42500,39715,85000,39715,0
3.0,85000,2,0.075,84,42500,42068,84996,42064,-4
7.0,85000,7,0.125,294,42500,40890,84530,41716,826
5.0,85000,9,0.075,378,42500,41930,84999,41929,-1
12.0,85000,9,0.175,378,42500,42156,57210,42500,344
1.0,85000,5,0.075,210,42671,42671,84976,42671,0
8.0,85000,9,0.2,378,42500,42150,54042,42500,350
6.0,85000,6,0.225,252,42500,41625,50867,42500,875
4.0,85000,5,0.125,210,42500,41473,84787,41132,-341
2.0,85000,7,0.05,294,42500,39715,85000,39715,0
3.0,85000,2,0.1,84,42500,42068,84977,42035,-33
7.0,85000,7,0.15,294,42500,40890,81321,42364,1474
5.0,85000,9,0.1,378,42500,41930,84977,41872,-58
13.0,85000,9,0.05,378,42500,41809,85000,41809,0
11.0,85000,9,0.15,378,42500,41514,75940,42500,986
8.0,85000,9,0.225,378,42500,42150,45658,42500,350
10.0,85000,9,0.175,378,42500,40742,62536,42500,1758
6.0,85000,6,0.25,252,42500,41625,44685,42499,874
1.0,85000,5,0.1,210,42671,42671,84884,42667,-4
2.0,85000,7,0.075,294,42500,39715,84995,39698,-17
4.0,85000,5,0.15,210,42500,41473,83422,41053,-420
3.0,85000,2,0.125,84,42500,42068,84810,41822,-246
12.0,85000,9,0.2,378,42500,42156,45674,42500,344
7.0,85000,7,0.175,294,42500,40890,72121,42500,1610
5.0,85000,9,0.125,378,42500,41930,84649,41155,-775
8.0,85000,9,0.25,378,42500,42150,42976,42500,350
6.0,85000,7,0.025,294,42500,41221,85000,41221,0
13.0,85000,9,0.075,378,42500,41809,84999,41808,-1
11.0,85000,9,0.175,378,42500,41514,59931,42500,986
10.0,85000,9,0.2,378,42500,40742,48942,42500,1758
2.0,85000,7,0.1,294,42500,39715,84949,39594,-121
3.0,85000,2,0.15,84,42500,42068,83978,40757,-1311
4.0,85000,5,0.175,210,42500,41473,79655,42366,893
12.0,85000,9,0.225,378,42500,42156,42808,42500,344
1.0,85000,5,0.125,210,42671,42671,84579,42664,-7
7.0,85000,7,0.2,294,42500,40890,58147,42500,1610
5.0,85000,9,0.15,378,42500,41930,82767,41801,-129
11.0,85000,9,0.2,378,42500,41514,47097,42500,986
10.0,85000,9,0.225,378,42500,40742,43606,42499,1757
6.0,85000,7,0.05,294,42500,41221,85000,41221,0
13.0,85000,9,0.1,378,42500,41809,84896,41531,-278
12.0,85000,9,0.25,378,42500,42156,42516,42499,343
2.0,85000,7,0.125,294,42500,39715,84716,38077,-1638
3.0,85000,2,0.175,84,42500,42068,80696,42165,97
11.0,85000,9,0.225,378,42500,41514,43080,42500,986
10.0,85000,9,0.25,378,42500,40742,42585,42498,1756
4.0,85000,5,0.2,210,42500,41473,70731,42498,1025
7.0,85000,7,0.225,294,42500,40890,47616,42500,1610
1.0,85000,5,0.15,210,42671,42671,83616,42654,-17
5.0,85000,9,0.175,378,42500,41930,76855,42451,521
13.0,85000,9,0.125,378,42500,41809,82921,42500,691
6.0,85000,7,0.075,294,42500,41221,85000,41221,0
11.0,85000,9,0.25,378,42500,41514,42546,42500,986
2.0,85000,7,0.15,294,42500,39715,83783,40056,341
3.0,85000,2,0.2,84,42500,42068,74292,42484,416
4.0,85000,5,0.225,210,42500,41473,59283,42498,1025
7.0,85000,7,0.25,294,42500,40890,43576,42499,1609
5.0,85000,9,0.2,378,42500,41930,65343,42499,569
6.0,85000,7,0.1,294,42500,41221,84978,41200,-21
13.0,85000,9,0.15,378,42500,41809,72411,42500,691
1.0,85000,5,0.175,210,42671,42671,82443,42633,-38
3.0,85000,2,0.225,84,42500,42068,64823,42497,429
4.0,85000,5,0.25,210,42500,41473,49751,42489,1016
7.0,85000,8,0.025,336,42500,40367,85000,40367,0
2.0,85000,7,0.175,294,42500,39715,81832,40067,352
5.0,85000,9,0.225,378,42500,41930,54091,42498,568
6.0,85000,7,0.125,294,42500,41221,84617,40172,-1049
3.0,85000,2,0.25,84,42500,42068,54907,42481,413
7.0,85000,8,0.05,336,42500,40367,85000,40367,0
4.0,85000,6,0.025,252,42500,41397,85000,41397,0
13.0,85000,9,0.175,378,42500,41809,54518,42500,691
2.0,85000,7,0.2,294,42500,39715,76787,42199,2484
5.0,85000,9,0.25,378,42500,41930,46468,42495,565
1.0,85000,5,0.2,210,42671,42671,78734,42596,-75
6.0,85000,7,0.15,294,42500,41221,82246,42333,1112
7.0,85000,8,0.075,336,42500,40367,85000,40367,0
3.0,85000,3,0.025,126,42500,39435,85000,39435,0
4.0,85000,6,0.05,252,42500,41397,85000,41397,0
2.0,85000,7,0.225,294,42500,39715,69748,42453,2738
13.0,85000,9,0.2,378,42500,41809,44644,42500,691
1.0,85000,5,0.225,210,42671,42671,74414,42537,-134
6.0,85000,7,0.175,294,42500,41221,74220,42500,1279
7.0,85000,8,0.1,336,42500,40367,84968,40060,-307
3.0,85000,3,0.05,126,42500,39435,85000,39435,0
4.0,85000,6,0.075,252,42500,41397,84998,41377,-20
2.0,85000,7,0.25,294,42500,39715,60454,42452,2737
13.0,85000,9,0.225,378,42500,41809,42657,42500,691
6.0,85000,7,0.2,294,42500,41221,61982,42500,1279
7.0,85000,8,0.125,336,42500,40367,84521,40400,33
3.0,85000,3,0.075,126,42500,39435,84999,39422,-13
4.0,85000,6,0.1,252,42500,41397,84978,41303,-94
1.0,85000,5,0.25,210,42671,42671,68908,42448,-223
2.0,85000,8,0.025,336,42501,40288,85000,40288,0
6.0,85000,7,0.225,294,42500,41221,50429,42499,1278
13.0,85000,9,0.25,378,42500,41809,42502,42500,691
7.0,85000,8,0.15,336,42500,40367,81396,42293,1926
3.0,85000,3,0.1,126,42500,39435,84976,39354,-81
4.0,85000,6,0.125,252,42500,41397,84782,40938,-459
6.0,85000,7,0.25,294,42500,41221,44523,42498,1277
1.0,85000,6,0.025,252,42658,42647,85000,42647,0
2.0,85000,8,0.05,336,42501,40288,84998,40288,0
7.0,85000,8,0.175,336,42500,40367,72118,42500,2133
3.0,85000,3,0.125,126,42500,39435,84794,40155,720
4.0,85000,6,0.15,252,42500,41397,83469,40703,-694
6.0,85000,8,0.025,336,42500,41464,85000,41464,0
7.0,85000,8,0.2,336,42500,40367,58234,42500,2133
2.0,85000,8,0.075,336,42501,40288,84993,40288,0
3.0,85000,3,0.15,126,42500,39435,83872,40166,731
4.0,85000,6,0.175,252,42500,41397,79632,42158,761
1.0,85000,6,0.05,252,42658,42647,85000,42647,0
6.0,85000,8,0.05,336,42500,41464,85000,41464,0
7.0,85000,8,0.225,336,42500,40367,47756,42500,2133
3.0,85000,3,0.175,126,42500,39435,80632,41979,2544
4.0,85000,6,0.2,252,42500,41397,70950,42495,1098
2.0,85000,8,0.1,336,42501,40288,84959,40288,0
7.0,85000,8,0.25,336,42500,40367,43596,42499,2132
6.0,85000,8,0.075,336,42500,41464,84999,41463,-1
1.0,85000,6,0.075,252,42658,42647,84986,42634,-13
7.0,85000,9,0.025,378,42500,41277,85000,41277,0
6.0,85000,8,0.1,336,42500,41464,84978,41413,-51
3.0,85000,3,0.2,126,42500,39435,74185,42468,3033
2.0,85000,8,0.125,336,42501,40288,84751,40329,41
4.0,85000,6,0.225,252,42500,41397,59494,42497,1100
1.0,85000,6,0.1,252,42658,42647,84916,42572,-75
